codigo_municipio,municipio,uf,proporcao_haddad,proporcao_bolsonaro,votos_haddad,votos_bolsonaro,votos_validos
1200401,RIO BRANCO,AC,0.172,0.828,32937,158264,191201
1200203,CRUZEIRO DO SUL,AC,0.201,0.799,7818,31147,38965
1200500,SENA MADUREIRA,AC,0.235,0.765,3711,12051,15762
1200450,SENADOR GUIOMARD,AC,0.193,0.807,2452,10247,12699
1200104,BRASILÉIA,AC,0.269,0.731,3208,8711,11919
1200609,TARAUACÁ,AC,0.388,0.612,5267,8292,13559
1200807,PORTO ACRE,AC,0.224,0.776,2059,7150,9209
1200385,PLÁCIDO DE CASTRO,AC,0.22,0.78,1837,6531,8368
1200302,FEIJÓ,AC,0.455,0.545,5256,6296,11552
1200252,EPITACIOLÂNDIA,AC,0.244,0.756,2026,6284,8310
1200336,MÂNCIO LIMA,AC,0.309,0.691,2334,5225,7559
1200013,ACRELÂNDIA,AC,0.201,0.799,1300,5165,6465
1200708,XAPURI,AC,0.408,0.592,3400,4929,8329
1200427,RODRIGUES ALVES,AC,0.261,0.739,1682,4762,6444
1200138,BUJARI,AC,0.214,0.786,1274,4676,5950
1200179,CAPIXABA,AC,0.218,0.782,1086,3895,4981
1200351,MARECHAL THAUMATURGO,AC,0.49,0.51,2451,2548,4999
1200054,ASSIS BRASIL,AC,0.416,0.584,1660,2333,3993
1200344,MANOEL URBANO,AC,0.416,0.584,1621,2274,3895
1200393,PORTO WALTER,AC,0.389,0.611,1208,1897,3105
1200328,JORDÃO,AC,0.507,0.493,1415,1375,2790
1200435,SANTA ROSA DO PURUS,AC,0.535,0.465,975,847,1822
2704302,MACEIÓ,AL,0.384,0.616,166838,268027,434865
2700300,ARAPIRACA,AL,0.54,0.46,56755,48375,105130
2707701,RIO LARGO,AL,0.503,0.497,19803,19583,39386
2704708,MARECHAL DEODORO,AL,0.433,0.567,10713,14007,24720
2702306,CORURIPE,AL,0.445,0.555,11098,13819,24917
2708600,SÃO MIGUEL DOS CAMPOS,AL,0.489,0.511,13156,13765,26921
2706307,PALMEIRA DOS ÍNDIOS,AL,0.676,0.324,23153,11083,34236
2709301,UNIÃO DOS PALMARES,AL,0.667,0.333,19928,9943,29871
2706703,PENEDO,AL,0.642,0.358,17029,9490,26519
2706901,PILAR,AL,0.532,0.468,9463,8313,17776
2704500,MARAGOGI,AL,0.456,0.544,6265,7462,13727
2709152,TEOTÔNIO VILELA,AL,0.644,0.356,12110,6684,18794
2700409,ATALAIA,AL,0.683,0.317,13524,6287,19811
2707305,PORTO CALVO,AL,0.501,0.499,5982,5950,11932
2705101,MATRIZ DE CAMARAGIBE,AL,0.514,0.486,6213,5879,12092
2708501,SÃO LUÍS DO QUITUNDE,AL,0.581,0.419,8142,5877,14019
2708006,SANTANA DO IPANEMA,AL,0.788,0.212,17425,4678,22103
2705507,MURICI,AL,0.635,0.365,7965,4584,12549
2701001,BOCA DA MATA,AL,0.633,0.367,7788,4521,12309
2701407,CAMPO ALEGRE,AL,0.731,0.269,11526,4239,15765
2708303,SÃO JOSÉ DA LAJE,AL,0.631,0.369,7192,4203,11395
2709400,VIÇOSA,AL,0.686,0.314,8972,4105,13077
2702405,DELMIRO GOUVEIA,AL,0.849,0.151,22523,4009,26532
2708907,SATUBA,AL,0.49,0.51,3531,3681,7212
2704005,JUNQUEIRO,AL,0.713,0.287,8973,3609,12582
2702108,COLÔNIA LEOPOLDINA,AL,0.611,0.389,5582,3559,9141
2706448,PARIPUEIRA,AL,0.471,0.529,3164,3554,6718
2708808,SÃO SEBASTIÃO,AL,0.796,0.204,13577,3483,17060
2705200,MESSIAS,AL,0.617,0.383,5415,3367,8782
2701704,CAPELA,AL,0.617,0.383,5192,3222,8414
2705705,OLHO D'ÁGUA DAS FLORES,AL,0.698,0.302,7149,3090,10239
2700508,BARRA DE SANTO ANTÔNIO,AL,0.63,0.37,4923,2893,7816
2701308,CAJUEIRO,AL,0.706,0.294,6380,2652,9032
2702801,FLEXEIRAS,AL,0.524,0.476,2780,2526,5306
2706505,PASSO DE CAMARAGIBE,AL,0.656,0.344,4712,2470,7182
2703007,IBATEGUARA,AL,0.664,0.336,4865,2464,7329
2703205,IGREJA NOVA,AL,0.795,0.205,9410,2427,11837
2700607,BARRA DE SÃO MIGUEL,AL,0.494,0.506,2346,2400,4746
2704401,MAJOR ISIDORO,AL,0.753,0.247,7264,2379,9643
2704203,LIMOEIRO DE ANADIA,AL,0.808,0.192,9971,2362,12333
2702900,GIRAU DO PONCIANO,AL,0.872,0.128,15898,2338,18236
2706802,PIAÇABUÇU,AL,0.725,0.275,6070,2306,8376
2706406,PÃO DE AÇÚCAR,AL,0.803,0.197,9356,2301,11657
2704104,LAGOA DA CANOA,AL,0.782,0.218,8222,2297,10519
2705606,NOVO LINO,AL,0.582,0.418,3108,2233,5341
2703759,JEQUIÁ DA PRAIA,AL,0.547,0.453,2639,2184,4823
2702603,FEIRA GRANDE,AL,0.829,0.171,10412,2144,12556
2703809,JOAQUIM GOMES,AL,0.765,0.235,6950,2138,9088
2702355,CRAÍBAS,AL,0.842,0.158,11200,2099,13299
2700706,BATALHA,AL,0.751,0.249,6261,2072,8333
2708709,SÃO MIGUEL DOS MILAGRES,AL,0.509,0.491,2093,2021,4114
2704807,MARIBONDO,AL,0.698,0.302,4667,2017,6684
2709103,TAQUARANA,AL,0.787,0.213,7341,1986,9327
2703601,JAPARATINGA,AL,0.513,0.487,2066,1962,4028
2703106,IGACI,AL,0.854,0.146,11111,1901,13012
2708402,SÃO JOSÉ DA TAPERA,AL,0.871,0.129,12282,1826,14108
2707503,PORTO REAL DO COLÉGIO,AL,0.836,0.164,8966,1759,10725
2700201,ANADIA,AL,0.783,0.217,6182,1711,7893
2707404,PORTO DE PEDRAS,AL,0.584,0.416,2367,1683,4050
2707909,SANTA LUZIA DO NORTE,AL,0.613,0.387,2586,1635,4221
2705002,MATA GRANDE,AL,0.861,0.139,9558,1537,11095
2709202,TRAIPU,AL,0.865,0.135,9658,1508,11166
2707602,QUEBRANGULO,AL,0.78,0.22,5053,1429,6482
2702207,COQUEIRO SECO,AL,0.614,0.386,2016,1265,3281
2707107,PIRANHAS,AL,0.9,0.1,11252,1250,12502
2701100,BRANQUINHA,AL,0.764,0.236,3756,1160,4916
2701209,CACIMBINHAS,AL,0.787,0.213,4166,1125,5291
2708105,SANTANA DO MUNDAÚ,AL,0.811,0.189,4729,1105,5834
2707800,ROTEIRO,AL,0.665,0.335,2183,1102,3285
2706604,PAULO JACINTO,AL,0.725,0.275,2868,1086,3954
2702504,DOIS RIACHOS,AL,0.806,0.194,4444,1072,5516
2706000,OLIVENÇA,AL,0.837,0.163,5134,1002,6136
2702009,COITÉ DO NÓIA,AL,0.839,0.161,5010,964,5974
2703304,INHAPI,AL,0.886,0.114,7102,918,8020
2701605,CANAPI,AL,0.894,0.106,7618,905,8523
2708204,SÃO BRÁS,AL,0.779,0.221,3103,879,3982
2703908,JUNDIÁ,AL,0.644,0.356,1547,855,2402
2702553,ESTRELA DE ALAGOAS,AL,0.889,0.111,6783,851,7634
2701506,CAMPO GRANDE,AL,0.856,0.144,5022,843,5865
2706109,OURO BRANCO,AL,0.862,0.138,5156,828,5984
2700102,ÁGUA BRANCA,AL,0.921,0.079,9520,812,10332
2704609,MARAVILHA,AL,0.843,0.157,4341,810,5151
2701902,CHÃ PRETA,AL,0.792,0.208,2994,788,3782
2708956,SENADOR RUI PALMEIRA,AL,0.872,0.128,5287,776,6063
2701357,CAMPESTRE,AL,0.777,0.223,2594,745,3339
2703502,JACUÍPE,AL,0.793,0.207,2736,715,3451
2702702,FELIZ DESERTO,AL,0.673,0.327,1417,689,2106
2700805,BELÉM,AL,0.786,0.214,2511,684,3195
2707206,POÇO DAS TRINCHEIRAS,AL,0.909,0.091,6226,625,6851
2705309,MINADOR DO NEGRÃO,AL,0.815,0.185,2607,591,3198
2705408,MONTEIRÓPOLIS,AL,0.85,0.15,3247,574,3821
2704906,MAR VERMELHO,AL,0.761,0.239,1788,563,2351
2701803,CARNEIROS,AL,0.876,0.124,3873,547,4420
2709004,TANQUE D'ARCA,AL,0.856,0.144,2987,504,3491
2700904,BELO MONTE,AL,0.858,0.142,2928,486,3414
2707008,PINDOBA,AL,0.718,0.282,1210,475,1685
2703700,JARAMATAIA,AL,0.859,0.141,2806,462,3268
2703403,JACARÉ DOS HOMENS,AL,0.873,0.127,2981,434,3415
2706208,PALESTINA,AL,0.843,0.157,2291,428,2719
2705903,OLHO D'ÁGUA GRANDE,AL,0.878,0.122,2687,374,3061
2706422,PARICONHA,AL,0.939,0.061,5777,374,6151
2705804,OLHO D'ÁGUA DO CASADO,AL,0.934,0.066,4494,319,4813
1600303,MACAPÁ,AP,0.449,0.551,98083,120603,218686
1600600,SANTANA,AP,0.468,0.532,27662,31383,59045
1600279,LARANJAL DO JARI,AP,0.589,0.411,11044,7703,18747
1600535,PORTO GRANDE,AP,0.588,0.412,5250,3681,8931
1600501,OIAPOQUE,AP,0.671,0.329,7335,3589,10924
1600402,MAZAGÃO,AP,0.694,0.306,7628,3361,10989
1600154,PEDRA BRANCA DO AMAPARI,AP,0.598,0.402,3317,2234,5551
1600709,TARTARUGALZINHO,AP,0.637,0.363,3670,2092,5762
1600808,VITÓRIA DO JARI,AP,0.728,0.272,4565,1704,6269
1600204,CALÇOENE,AP,0.653,0.347,3140,1671,4811
1600238,FERREIRA GOMES,AP,0.564,0.436,2143,1659,3802
1600105,AMAPÁ,AP,0.647,0.353,2610,1423,4033
1600253,ITAUBAL,AP,0.669,0.331,2530,1250,3780
1600055,SERRA DO NAVIO,AP,0.509,0.491,1240,1196,2436
1600212,CUTIAS,AP,0.71,0.29,1961,800,2761
1600550,PRACUÚBA,AP,0.658,0.342,1438,747,2185
1302603,MANAUS,AM,0.343,0.657,358364,686999,1045363
1302504,MANACAPURU,AM,0.605,0.395,27255,17778,45033
1301902,ITACOATIARA,AM,0.655,0.345,29226,15412,44638
1301209,COARI,AM,0.688,0.312,21399,9690,31089
1301852,IRANDUBA,AM,0.623,0.377,14447,8757,23204
1303403,PARINTINS,AM,0.825,0.175,38970,8266,47236
1304203,TEFÉ,AM,0.698,0.302,18878,8159,27037
1301704,HUMAITÁ,AM,0.577,0.423,10398,7609,18007
1304062,TABATINGA,AM,0.691,0.309,15809,7061,22870
1303536,PRESIDENTE FIGUEIREDO,AM,0.578,0.422,8669,6337,15006
1300706,BOCA DO ACRE,AM,0.525,0.475,6782,6129,12911
1302702,MANICORÉ,AM,0.714,0.286,12543,5016,17559
1303569,RIO PRETO DA EVA,AM,0.53,0.47,5368,4751,10119
1300300,AUTAZES,AM,0.733,0.267,12407,4509,16916
1301100,CAREIRO,AM,0.695,0.305,9464,4160,13624
1303809,SÃO GABRIEL DA CACHOEIRA,AM,0.776,0.224,13369,3864,17233
1302405,LÁBREA,AM,0.757,0.243,11291,3633,14924
1300144,APUÍ,AM,0.486,0.514,3046,3218,6264
1301407,EIRUNEPÉ,AM,0.738,0.262,8836,3137,11973
1302900,MAUÉS,AM,0.843,0.157,16543,3080,19623
1301308,CODAJÁS,AM,0.642,0.358,5455,3044,8499
1303205,NOVO AIRÃO,AM,0.586,0.414,4289,3033,7322
1301654,GUAJARÁ,AM,0.495,0.505,2782,2836,5618
1301159,CAREIRO DA VÁRZEA,AM,0.721,0.279,7239,2795,10034
1304104,TAPAUÁ,AM,0.683,0.317,5288,2457,7745
1301001,CARAUARI,AM,0.802,0.198,9617,2370,11987
1300102,ANORI,AM,0.62,0.38,3681,2253,5934
1300805,BORBA,AM,0.827,0.173,10727,2238,12965
1300607,BENJAMIN CONSTANT,AM,0.858,0.142,12275,2026,14301
1303106,NOVA OLINDA DO NORTE,AM,0.805,0.195,8303,2016,10319
1300409,BARCELOS,AM,0.654,0.346,3608,1913,5521
1300631,BERURI,AM,0.756,0.244,5670,1831,7501
1302009,ITAPIRANGA,AM,0.608,0.392,2843,1831,4674
1303957,SÃO SEBASTIÃO DO UATUMÃ,AM,0.574,0.426,2430,1803,4233
1300086,ANAMÃ,AM,0.697,0.303,4077,1771,5848
1302553,MANAQUIRI,AM,0.777,0.223,6076,1744,7820
1300904,CANUTAMA,AM,0.665,0.335,3359,1691,5050
1303700,SANTO ANTÔNIO DO IÇÁ,AM,0.828,0.172,7998,1662,9660
1301605,FONTE BOA,AM,0.827,0.173,7837,1645,9482
1303502,PAUINI,AM,0.736,0.264,4437,1593,6030
1304302,URUCARÁ,AM,0.789,0.211,5785,1547,7332
1303908,SÃO PAULO DE OLIVENÇA,AM,0.877,0.123,10907,1535,12442
1304401,URUCURITUBA,AM,0.81,0.19,6256,1466,7722
1303601,SANTA ISABEL DO RIO NEGRO,AM,0.648,0.352,2637,1430,4067
1301506,ENVIRA,AM,0.776,0.224,4870,1405,6275
1300839,CAAPIRANGA,AM,0.713,0.287,3449,1387,4836
1303304,NOVO ARIPUANÃ,AM,0.811,0.189,5923,1383,7306
1300029,ALVARÃES,AM,0.793,0.207,5295,1380,6675
1302306,JUTAÍ,AM,0.815,0.185,6049,1373,7422
1301803,IPIXUNA,AM,0.794,0.206,5055,1312,6367
1303007,NHAMUNDÁ,AM,0.853,0.147,7447,1280,8727
1302207,JURUÁ,AM,0.705,0.295,2829,1185,4014
1304260,UARINI,AM,0.772,0.228,3692,1089,4781
1300508,BARREIRINHA,AM,0.918,0.082,11611,1036,12647
1304237,TONANTINS,AM,0.842,0.158,5410,1013,6423
1300201,ATALAIA DO NORTE,AM,0.825,0.175,4020,851,4871
1300060,AMATURÁ,AM,0.801,0.199,3400,846,4246
1302801,MARAÃ,AM,0.831,0.169,4114,835,4949
1300680,BOA VISTA DO RAMOS,AM,0.892,0.108,6666,808,7474
1304005,SILVES,AM,0.835,0.165,3966,784,4750
1301951,ITAMARATI,AM,0.835,0.165,3497,691,4188
1302108,JAPURÁ,AM,0.747,0.253,1912,648,2560
2927408,SALVADOR,BA,0.686,0.314,985532,451273,1436805
2910800,FEIRA DE SANTANA,BA,0.629,0.371,194826,115156,309982
2933307,VITÓRIA DA CONQUISTA,BA,0.581,0.419,100751,72763,173514
2914802,ITABUNA,BA,0.513,0.487,53396,50668,104064
2905701,CAMAÇARI,BA,0.649,0.351,84052,45483,129535
2913606,ILHÉUS,BA,0.607,0.393,54505,35315,89820
2931350,TEIXEIRA DE FREITAS,BA,0.49,0.51,33442,34772,68214
2918407,JUAZEIRO,BA,0.697,0.303,79982,34740,114722
2919207,LAURO DE FREITAS,BA,0.657,0.343,62336,32596,94932
2903201,BARREIRAS,BA,0.595,0.405,43898,29915,73813
2910727,EUNÁPOLIS,BA,0.506,0.494,29184,28502,57686
2925303,PORTO SEGURO,BA,0.574,0.426,38222,28354,66576
2918001,JEQUIÉ,BA,0.667,0.333,54000,27012,81012
2900702,ALAGOINHAS,BA,0.675,0.325,51668,24844,76512
2919553,LUÍS EDUARDO MAGALHÃES,BA,0.412,0.588,15773,22509,38282
2928703,SANTO ANTÔNIO DE JESUS,BA,0.665,0.335,34032,17154,51186
2916401,ITAPETINGA,BA,0.463,0.537,14784,17138,31922
2911709,GUANAMBI,BA,0.677,0.323,32336,15405,47741
2930709,SIMÕES FILHO,BA,0.735,0.265,42380,15305,57685
2932903,VALENÇA,BA,0.693,0.307,31374,13897,45271
2915601,ITAMARAJU,BA,0.552,0.448,16393,13312,29705
2908408,CONCEIÇÃO DO COITÉ,BA,0.649,0.351,24197,13094,37291
2904605,BRUMADO,BA,0.678,0.322,25911,12294,38205
2924009,PAULO AFONSO,BA,0.792,0.208,45685,12010,57695
2930105,SENHOR DO BONFIM,BA,0.673,0.327,24241,11791,36032
2909802,CRUZ DAS ALMAS,BA,0.702,0.298,25147,10681,35828
2917508,JACOBINA,BA,0.763,0.237,31586,9815,41401
2930501,SERRINHA,BA,0.781,0.219,34236,9579,43815
2914604,IRECÊ,BA,0.739,0.261,25824,9137,34961
2906006,CAMPO FORMOSO,BA,0.764,0.236,28718,8852,37570
2910057,DIAS D'ÁVILA,BA,0.75,0.25,26227,8750,34977
2923001,NOVA VIÇOSA,BA,0.544,0.456,10087,8462,18549
2914703,ITABERABA,BA,0.749,0.251,22358,7473,29831
2906501,CANDEIAS,BA,0.847,0.153,39448,7101,46549
2926608,RIBEIRA DO POMBAL,BA,0.762,0.238,22235,6955,29190
2917607,JAGUAQUARA,BA,0.699,0.301,15962,6871,22833
2922003,MUCURI,BA,0.591,0.409,9901,6847,16748
2913903,IPIAÚ,BA,0.686,0.314,14489,6627,21116
2907202,CASA NOVA,BA,0.835,0.165,32131,6359,38490
2901007,AMARGOSA,BA,0.668,0.332,12470,6203,18673
2903904,BOM JESUS DA LAPA,BA,0.801,0.199,24779,6165,30944
2921005,MATA DE SÃO JOÃO,BA,0.781,0.219,21916,6152,28068
2905206,CAETITÉ,BA,0.793,0.207,23063,6006,29069
2907509,CATU,BA,0.793,0.207,22901,5989,28890
2914000,IPIRÁ,BA,0.824,0.176,26759,5709,32468
2911204,GANDU,BA,0.631,0.369,9436,5526,14962
2925105,POÇÕES,BA,0.758,0.242,17322,5524,22846
2927705,SANTA CRUZ CABRÁLIA,BA,0.6,0.4,7788,5186,12974
2905800,CAMAMU,BA,0.653,0.347,9733,5178,14911
2906303,CANAVIEIRAS,BA,0.673,0.327,10644,5176,15820
2925501,PRADO,BA,0.622,0.378,8143,4946,13089
2928109,SANTA MARIA DA VITÓRIA,BA,0.753,0.247,15090,4946,20036
2906873,CAPIM GROSSO,BA,0.679,0.321,10375,4900,15275
2921104,MEDEIROS NETO,BA,0.591,0.409,7044,4883,11927
2933208,VERA CRUZ,BA,0.786,0.214,17888,4875,22763
2927002,RIO REAL,BA,0.752,0.248,14587,4807,19394
2933604,XIQUE-XIQUE,BA,0.798,0.202,18982,4804,23786
2904704,BUERAREMA,BA,0.447,0.553,3803,4698,8501
2919504,LIVRAMENTO DE NOSSA SENHORA,BA,0.805,0.195,19346,4674,24020
2910701,EUCLIDES DA CUNHA,BA,0.845,0.155,25434,4674,30108
2928604,SANTO AMARO,BA,0.86,0.14,28707,4665,33372
2914653,ITABELA,BA,0.674,0.326,9637,4654,14291
2928000,SANTALUZ,BA,0.778,0.222,16173,4611,20784
2933000,VALENTE,BA,0.672,0.328,9419,4591,14010
2912103,IBICARAÍ,BA,0.624,0.376,7615,4587,12202
2917003,ITIÚBA,BA,0.754,0.246,13970,4548,18518
2908507,CONCEIÇÃO DO JACUÍPE,BA,0.743,0.257,12952,4475,17427
2928802,SANTO ESTÊVÃO,BA,0.842,0.158,23419,4379,27798
2931905,TUCANO,BA,0.842,0.158,23170,4339,27509
2925204,POJUCA,BA,0.776,0.224,14811,4270,19081
2905602,CAMACAN,BA,0.632,0.368,7323,4265,11588
2907103,CARINHANHA,BA,0.704,0.296,10147,4264,14411
2928901,SÃO DESIDÉRIO,BA,0.747,0.253,12390,4193,16583
2913200,IBOTIRAMA,BA,0.703,0.297,9651,4085,13736
2932705,URUÇUCA,BA,0.638,0.362,7114,4036,11150
2930204,SENTO SÉ,BA,0.787,0.213,14681,3970,18651
2929305,SÃO GONÇALO DOS CAMPOS,BA,0.817,0.183,17663,3953,21616
2919801,MACAÚBAS,BA,0.819,0.181,17824,3933,21757
2925758,PRESIDENTE TANCREDO NEVES,BA,0.711,0.289,9629,3923,13552
2920601,MARAGOGIPE,BA,0.833,0.167,19520,3915,23435
2916005,ITANHÉM,BA,0.613,0.387,6182,3911,10093
2928208,SANTANA,BA,0.729,0.271,10309,3825,14134
2910503,ENTRE RIOS,BA,0.817,0.183,16995,3797,20792
2917300,ITUBERÁ,BA,0.684,0.316,8178,3786,11964
2902906,BARRA DO CHOÇA,BA,0.803,0.197,15363,3762,19125
2909307,CORRENTINA,BA,0.784,0.216,13658,3753,17411
2907806,CÍCERO DANTAS,BA,0.79,0.21,14002,3724,17726
2918357,JOÃO DOURADO,BA,0.703,0.297,8736,3697,12433
2905008,CACULÉ,BA,0.693,0.307,8317,3692,12009
2916807,ITARANTIM,BA,0.597,0.403,5406,3656,9062
2922409,MUTUÍPE,BA,0.69,0.31,8139,3653,11792
2902708,BARRA,BA,0.85,0.15,20502,3628,24130
2917102,ITORORÓ,BA,0.643,0.357,6523,3620,10143
2930303,SERRA DOURADA,BA,0.64,0.36,6343,3570,9913
2921203,MIGUEL CALMON,BA,0.742,0.258,10224,3564,13788
2917706,JAGUARARI,BA,0.78,0.22,12539,3532,16071
2908002,COARACI,BA,0.67,0.33,7163,3523,10686
2913705,INHAMBUPE,BA,0.804,0.196,14299,3496,17795
2913507,IGUAÍ,BA,0.701,0.299,8184,3490,11674
2915502,ITAJUÍPE,BA,0.689,0.311,7686,3474,11160
2926004,REMANSO,BA,0.843,0.157,18005,3356,21361
2925006,PLANALTO,BA,0.748,0.252,9874,3334,13208
2910602,ESPLANADA,BA,0.805,0.195,13746,3320,17066
2915809,ITAMBÉ,BA,0.707,0.293,8003,3317,11320
2929503,SÃO SEBASTIÃO DO PASSÉ,BA,0.87,0.13,22150,3310,25460
2932507,UNA,BA,0.669,0.331,6683,3304,9987
2918803,LAJE,BA,0.752,0.248,9992,3294,13286
2902104,ARACI,BA,0.873,0.127,22617,3290,25907
2911105,FORMOSA DO RIO PRETO,BA,0.732,0.268,8943,3281,12224
2912905,IBIRATAIA,BA,0.676,0.324,6796,3264,10060
2929206,SÃO FRANCISCO DO CONDE,BA,0.872,0.128,21780,3204,24984
2927200,RUY BARBOSA,BA,0.786,0.214,11766,3202,14968
2922508,NAZARÉ,BA,0.794,0.206,12299,3186,15485
2908101,COCOS,BA,0.709,0.291,7742,3180,10922
2919702,MACARANI,BA,0.62,0.38,5177,3179,8356
2902807,BARRA DA ESTIVA,BA,0.768,0.232,10421,3149,13570
2921708,MORRO DO CHAPÉU,BA,0.814,0.186,13763,3146,16909
2931004,TANHAÇU,BA,0.752,0.248,9485,3125,12610
2929909,SEABRA,BA,0.876,0.124,21761,3077,24838
2917201,ITUAÇU,BA,0.709,0.291,7430,3045,10475
2932200,UBAITABA,BA,0.687,0.313,6565,2986,9551
2928406,SANTA RITA DE CÁSSIA,BA,0.795,0.205,11482,2968,14450
2932101,UBAÍRA,BA,0.73,0.27,7950,2947,10897
2929107,SÃO FELIPE,BA,0.756,0.244,9016,2913,11929
2906709,CÂNDIDO SALES,BA,0.776,0.224,10012,2888,12900
2904902,CACHOEIRA,BA,0.838,0.162,14904,2874,17778
2926301,RIACHÃO DO JACUÍPE,BA,0.858,0.142,17152,2839,19991
2930774,SOBRADINHO,BA,0.786,0.214,10296,2811,13107
2920502,MARACÁS,BA,0.795,0.205,10867,2804,13671
2908705,CONDEÚBA,BA,0.71,0.29,6823,2788,9611
2932309,UBATÃ,BA,0.674,0.326,5746,2780,8526
2923803,PARIPIRANGA,BA,0.833,0.167,13786,2761,16547
2919157,LAPÃO,BA,0.824,0.176,12866,2751,15617
2925956,RAFAEL JAMBEIRO,BA,0.757,0.243,8554,2742,11296
2903409,BELMONTE,BA,0.73,0.27,7351,2713,10064
2914505,IRARÁ,BA,0.833,0.167,13492,2698,16190
2922300,MURITIBA,BA,0.83,0.17,13169,2693,15862
2906907,CARAVELAS,BA,0.705,0.295,6443,2690,9133
2924603,PINDOBAÇU,BA,0.733,0.267,7370,2682,10052
2918100,JEREMOABO,BA,0.858,0.142,16180,2675,18855
2925808,QUEIMADAS,BA,0.796,0.204,10431,2670,13101
2930154,SERRA DO RAMALHO,BA,0.826,0.174,12645,2662,15307
2905404,CAIRU,BA,0.701,0.299,6230,2661,8891
2933505,WENCESLAU GUIMARÃES,BA,0.757,0.243,8044,2583,10627
2901106,AMÉLIA RODRIGUES,BA,0.804,0.196,10510,2568,13078
2902609,BAIXA GRANDE,BA,0.742,0.258,7344,2551,9895
2921807,MORTUGABA,BA,0.588,0.412,3645,2549,6194
2921500,MONTE SANTO,BA,0.91,0.09,25788,2546,28334
2912202,IBICOARA,BA,0.721,0.279,6576,2544,9120
2901205,ANAGÉ,BA,0.793,0.207,9762,2543,12305
2923357,OUROLÂNDIA,BA,0.726,0.274,6716,2537,9253
2908200,CONCEIÇÃO DA FEIRA,BA,0.797,0.203,9922,2533,12455
2929057,SÃO FÉLIX DO CORIBE,BA,0.681,0.319,5358,2513,7871
2911600,GOVERNADOR MANGABEIRA,BA,0.792,0.208,9480,2490,11970
2908903,CORAÇÃO DE MARIA,BA,0.834,0.166,12511,2490,15001
2925907,QUIJINGUE,BA,0.827,0.173,11907,2487,14394
2900801,ALCOBAÇA,BA,0.759,0.241,7839,2487,10326
2909901,CURAÇÁ,BA,0.859,0.141,15160,2484,17644
2911808,GUARATINGA,BA,0.74,0.26,7054,2484,9538
2926202,RIACHÃO DAS NEVES,BA,0.804,0.196,10056,2446,12502
2903508,BELO CAMPO,BA,0.744,0.256,7092,2443,9535
2924306,PIATÃ,BA,0.771,0.229,8169,2423,10592
2907905,CIPÓ,BA,0.726,0.274,6361,2402,8763
2927507,SANTA BÁRBARA,BA,0.817,0.183,10716,2396,13112
2924058,PÉ DE SERRA,BA,0.702,0.298,5609,2378,7987
2914901,ITACARÉ,BA,0.763,0.237,7618,2371,9989
2910404,ENCRUZILHADA,BA,0.764,0.236,7657,2368,10025
2916104,ITAPARICA,BA,0.812,0.188,10223,2363,12586
2903805,BOA VISTA DO TUPIM,BA,0.737,0.263,6496,2315,8811
2923704,PARATINGA,BA,0.855,0.145,13574,2306,15880
2924652,PINTADAS,BA,0.623,0.377,3776,2282,6058
2929602,SAPEAÇU,BA,0.795,0.205,8774,2263,11037
2912707,IBIRAPITANGA,BA,0.765,0.235,7291,2236,9527
2908606,CONDE,BA,0.807,0.193,9353,2235,11588
2912806,IBIRAPUÃ,BA,0.53,0.47,2475,2191,4666
2924405,PILÃO ARCADO,BA,0.878,0.122,15767,2188,17955
2919926,MADRE DE DEUS,BA,0.816,0.184,9663,2180,11843
2911907,IAÇU,BA,0.838,0.162,11236,2169,13405
2907301,CASTRO ALVES,BA,0.859,0.141,13090,2156,15246
2906204,CANARANA,BA,0.835,0.165,10898,2149,13047
2915205,ITAGIBÁ,BA,0.715,0.285,5367,2136,7503
2905305,CAFARNAUM,BA,0.772,0.228,7181,2123,9304
2920205,MALHADA,BA,0.756,0.244,6556,2121,8677
2926400,RIACHO DE SANTANA,BA,0.876,0.124,14886,2105,16991
2900207,ABARÉ,BA,0.782,0.218,7453,2077,9530
2924801,PIRITIBA,BA,0.777,0.223,7142,2054,9196
2913002,IBITIARA,BA,0.747,0.253,5962,2019,7981
2916856,ITATIM,BA,0.746,0.254,5934,2019,7953
2916203,ITAPÉ,BA,0.671,0.329,4073,1998,6071
2923605,PARAMIRIM,BA,0.821,0.179,9048,1979,11027
2906808,CANSANÇÃO,BA,0.895,0.105,16747,1971,18718
2918308,JITAÚNA,BA,0.746,0.254,5783,1969,7752
2910859,FILADÉLFIA,BA,0.791,0.209,7417,1959,9376
2904753,BURITIRAMA,BA,0.807,0.193,8175,1958,10133
2932408,UIBAÍ,BA,0.772,0.228,6564,1935,8499
2933455,WANDERLEY,BA,0.732,0.268,5167,1891,7058
2915106,ITAGI,BA,0.722,0.278,4868,1875,6743
2920106,MAIRI,BA,0.795,0.205,7235,1864,9099
2920007,MAIQUINIQUE,BA,0.612,0.388,2914,1848,4762
2931806,TREMEDAL,BA,0.807,0.193,7658,1831,9489
2912004,IBIASSUCÊ,BA,0.698,0.302,4198,1813,6011
2907608,CENTRAL,BA,0.808,0.192,7630,1808,9438
2902500,BAIANÓPOLIS,BA,0.782,0.218,6478,1804,8282
2923209,OLIVEIRA DOS BREJINHOS,BA,0.844,0.156,9734,1801,11535
2931202,TAPEROÁ,BA,0.797,0.203,7037,1787,8824
2909109,CORIBE,BA,0.786,0.214,6538,1784,8322
2912301,IBICUÍ,BA,0.751,0.249,5354,1773,7127
2930600,SERROLÂNDIA,BA,0.756,0.244,5459,1760,7219
2923902,PAU BRASIL,BA,0.636,0.364,3064,1753,4817
2900108,ABAÍRA,BA,0.607,0.393,2694,1742,4436
2931608,TEOLÂNDIA,BA,0.76,0.24,5519,1739,7258
2926707,RIO DE CONTAS,BA,0.784,0.216,6244,1722,7966
2925402,POTIRAGUÁ,BA,0.663,0.337,3372,1714,5086
2909703,CRISTÓPOLIS,BA,0.788,0.212,6381,1712,8093
2912509,IBIPITANGA,BA,0.787,0.213,6328,1711,8039
2932002,UAUÁ,BA,0.881,0.119,12716,1711,14427
2902005,ARACATU,BA,0.808,0.192,7154,1704,8858
2932457,UMBURANAS,BA,0.771,0.229,5659,1685,7344
2915007,ITAETÉ,BA,0.763,0.237,5405,1679,7084
2933174,VARZEDO,BA,0.727,0.273,4442,1665,6107
2925931,QUIXABEIRA,BA,0.69,0.31,3693,1660,5353
2901908,APORÁ,BA,0.805,0.195,6763,1643,8406
2919405,LICÍNIO DE ALMEIDA,BA,0.757,0.243,5119,1643,6762
2922102,MUNDO NOVO,BA,0.833,0.167,8149,1637,9786
2906600,CANDIBA,BA,0.799,0.201,6489,1632,8121
2901403,ANGICAL,BA,0.823,0.177,7552,1628,9180
2916906,ITIRUÇU,BA,0.728,0.272,4337,1622,5959
2904506,BROTAS DE MACAÚBAS,BA,0.736,0.264,4502,1613,6115
2908309,CONCEIÇÃO DO ALMEIDA,BA,0.844,0.156,8718,1608,10326
2923407,PALMAS DE MONTE ALTO,BA,0.871,0.129,10786,1604,12390
2932804,UTINGA,BA,0.814,0.186,6985,1598,8583
2904001,BONINAL,BA,0.761,0.239,5100,1598,6698
2917409,JACARACI,BA,0.797,0.203,6223,1581,7804
2930402,SERRA PRETA,BA,0.863,0.137,9968,1576,11544
2921906,MUCUGÊ,BA,0.744,0.256,4574,1575,6149
2929750,SAUBARA,BA,0.799,0.201,6200,1563,7763
2909000,CORDEIROS,BA,0.652,0.348,2914,1552,4466
2904308,BREJÕES,BA,0.772,0.228,5247,1550,6797
2924504,PINDAÍ,BA,0.829,0.171,7536,1550,9086
2916500,ITAPICURU,BA,0.897,0.103,13503,1549,15052
2905909,CAMPO ALEGRE DE LOURDES,BA,0.894,0.106,13064,1542,14606
2902658,BANZAÊ,BA,0.792,0.208,5815,1531,7346
2904803,CAATIBA,BA,0.666,0.334,3030,1521,4551
2922904,NOVA SOURE,BA,0.89,0.11,12266,1515,13781
2909604,CRISÓPOLIS,BA,0.861,0.139,9384,1515,10899
2925253,PONTO NOVO,BA,0.817,0.183,6770,1514,8284
2914109,IPUPIARA,BA,0.729,0.271,4059,1511,5570
2932606,URANDI,BA,0.828,0.172,7249,1504,8753
2928059,SANTA LUZIA,BA,0.703,0.297,3530,1489,5019
2923100,OLINDINA,BA,0.884,0.116,11325,1485,12810
2906857,CAPELA DO ALTO ALEGRE,BA,0.757,0.243,4610,1478,6088
2900306,ACAJUTIBA,BA,0.801,0.199,5944,1476,7420
2918209,JIQUIRIÇÁ,BA,0.79,0.21,5522,1469,6991
2920908,MASCOTE,BA,0.739,0.261,4133,1457,5590
2901601,ANTAS,BA,0.798,0.202,5717,1445,7162
2920700,MARAÚ,BA,0.823,0.177,6695,1436,8131
2913804,IPECAETÁ,BA,0.854,0.146,8417,1435,9852
2929701,SÁTIRO DIAS,BA,0.831,0.169,6992,1422,8414
2903276,BARROCAS,BA,0.857,0.143,8478,1420,9898
2915403,ITAJU DO COLÔNIA,BA,0.558,0.442,1767,1398,3165
2926103,RETIROLÂNDIA,BA,0.84,0.16,7296,1388,8684
2915304,ITAGIMIRIM,BA,0.655,0.345,2603,1372,3975
2913101,IBITITÁ,BA,0.87,0.13,9149,1371,10520
2931053,TANQUE NOVO,BA,0.854,0.146,8013,1370,9383
2921401,MIRANGABA,BA,0.837,0.163,6851,1338,8189
2922706,NOVA CANAÃ,BA,0.822,0.178,6150,1334,7484
2933059,VÁRZEA DA ROÇA,BA,0.816,0.184,5911,1332,7243
2929404,SÃO MIGUEL DAS MATAS,BA,0.795,0.205,5137,1324,6461
2919603,MACAJUBA,BA,0.772,0.228,4457,1319,5776
2901809,ANTÔNIO GONÇALVES,BA,0.773,0.227,4445,1308,5753
2921609,MORPARÁ,BA,0.734,0.266,3584,1298,4882
2931509,TEOFILÂNDIA,BA,0.887,0.113,10197,1296,11493
2920304,MALHADA DE PEDRAS,BA,0.758,0.242,4028,1283,5311
2924702,PIRIPÁ,BA,0.759,0.241,4032,1282,5314
2902401,AURELINO LEAL,BA,0.802,0.198,5154,1270,6424
2921302,MILAGRES,BA,0.783,0.217,4573,1267,5840
2909406,COTEGIPE,BA,0.834,0.166,6312,1259,7571
2923035,NOVO HORIZONTE,BA,0.805,0.195,5187,1257,6444
2911006,FLORESTA AZUL,BA,0.747,0.253,3691,1253,4944
2917359,JABORANDI,BA,0.787,0.213,4627,1252,5879
2913457,IGRAPIÚNA,BA,0.789,0.211,4674,1250,5924
2916302,ITAPEBI,BA,0.764,0.236,4032,1247,5279
2900405,ÁGUA FRIA,BA,0.84,0.16,6496,1241,7737
2902054,ARAÇÁS,BA,0.828,0.172,5945,1237,7182
2904050,BONITO,BA,0.855,0.145,7245,1225,8470
2904407,BREJOLÂNDIA,BA,0.763,0.237,3924,1221,5145
2917805,JAGUARIPE,BA,0.868,0.132,8024,1221,9245
2922730,NOVA FÁTIMA,BA,0.76,0.24,3858,1217,5075
2931301,TAPIRAMUTÁ,BA,0.818,0.182,5458,1216,6674
2904852,CABACEIRAS DO PARAGUAÇU,BA,0.865,0.135,7782,1214,8996
2922607,NILO PEÇANHA,BA,0.797,0.203,4765,1212,5977
2910750,FÁTIMA,BA,0.887,0.113,9416,1204,10620
2920403,MANOEL VITORINO,BA,0.861,0.139,7455,1203,8658
2928950,SÃO DOMINGOS,BA,0.77,0.23,4013,1201,5214
2930758,SÍTIO DO MATO,BA,0.809,0.191,5079,1196,6275
2918456,JUCURUÇU,BA,0.765,0.235,3875,1190,5065
2900355,ADUSTINA,BA,0.861,0.139,7361,1188,8549
2918902,LAJEDÃO,BA,0.594,0.406,1733,1186,2919
2933257,VEREDA,BA,0.696,0.304,2707,1184,3891
2926905,RIO DO PIRES,BA,0.791,0.209,4459,1176,5635
2906899,CARAÍBAS,BA,0.787,0.213,4323,1167,5490
2926657,RIBEIRÃO DO LARGO,BA,0.775,0.225,4022,1167,5189
2902252,ARATACA,BA,0.728,0.272,3076,1152,4228
2910776,FEIRA DA MATA,BA,0.657,0.343,2192,1145,3337
2906824,CANUDOS,BA,0.863,0.137,7222,1142,8364
2914307,IRAMAIA,BA,0.787,0.213,4202,1138,5340
2909208,CORONEL JOÃO SÁ,BA,0.879,0.121,8211,1130,9341
2900504,ÉRICO CARDOSO,BA,0.781,0.219,4018,1128,5146
2912400,IBIPEBA,BA,0.882,0.118,8410,1122,9532
2916708,ITAQUARA,BA,0.745,0.255,3274,1122,4396
2933158,VÁRZEA NOVA,BA,0.816,0.184,4960,1122,6082
2930006,SEBASTIÃO LARANJEIRAS,BA,0.769,0.231,3704,1114,4818
2927309,SALINAS DA MARGARIDA,BA,0.87,0.13,7395,1109,8504
2926806,RIO DO ANTÔNIO,BA,0.849,0.151,6208,1105,7313
2922755,NOVA IBIÁ,BA,0.661,0.339,2155,1104,3259
2922201,MUNIZ FERREIRA,BA,0.799,0.201,4375,1104,5479
2918555,JUSSARI,BA,0.633,0.367,1898,1102,3000
2915700,ITAMARI,BA,0.729,0.271,2957,1097,4054
2903300,BARRO PRETO,BA,0.712,0.288,2715,1096,3811
2929008,SÃO FÉLIX,BA,0.85,0.15,6214,1093,7307
2903235,BARRO ALTO,BA,0.844,0.156,5893,1091,6984
2930907,TABOCAS DO BREJO VELHO,BA,0.842,0.158,5802,1086,6888
2925709,PRESIDENTE JÂNIO QUADROS,BA,0.834,0.166,5414,1081,6495
2922250,MUQUÉM DO SÃO FRANCISCO,BA,0.822,0.178,4952,1071,6023
2933109,VÁRZEA DO POÇO,BA,0.751,0.249,3219,1067,4286
2906105,CANÁPOLIS,BA,0.819,0.181,4796,1057,5853
2929800,SAÚDE,BA,0.817,0.183,4664,1046,5710
2901155,AMÉRICA DOURADA,BA,0.878,0.122,7472,1037,8509
2931103,TANQUINHO,BA,0.808,0.192,4365,1036,5401
2924678,PIRAÍ DO NORTE,BA,0.771,0.229,3483,1035,4518
2919959,MAETINGA,BA,0.731,0.269,2806,1034,3840
2929255,SÃO GABRIEL,BA,0.913,0.087,10769,1031,11800
2906402,CANDEAL,BA,0.81,0.19,4392,1028,5420
2911303,GENTIO DO OURO,BA,0.847,0.153,5661,1020,6681
2918605,JUSSIAPE,BA,0.769,0.231,3387,1016,4403
2916609,ITAPITANGA,BA,0.74,0.26,2870,1011,3881
2933406,WAGNER,BA,0.779,0.221,3537,1005,4542
2913408,IGAPORÃ,BA,0.887,0.113,7844,997,8841
2910305,ELÍSIO MEDRADO,BA,0.79,0.21,3684,980,4664
2914406,IRAQUARA,BA,0.924,0.076,11729,968,12697
2929354,SÃO JOSÉ DA VITÓRIA,BA,0.688,0.312,2134,968,3102
2904209,BOTUPORÃ,BA,0.85,0.15,5404,956,6360
2917334,IUIU,BA,0.836,0.164,4823,946,5769
2931707,TERRA NOVA,BA,0.86,0.14,5785,940,6725
2927606,SANTA BRÍGIDA,BA,0.884,0.116,7110,934,8044
2922656,NORDESTINA,BA,0.858,0.142,5630,933,6563
2901700,ANTÔNIO CARDOSO,BA,0.894,0.106,7844,931,8775
2901957,APUAREMA,BA,0.766,0.234,3019,921,3940
2911857,HELIÓPOLIS,BA,0.891,0.109,7429,913,8342
2911402,GLÓRIA,BA,0.906,0.094,8662,894,9556
2930766,SÍTIO DO QUINTO,BA,0.863,0.137,5595,890,6485
2927804,SANTA CRUZ DA VITÓRIA,BA,0.648,0.352,1634,889,2523
2903706,BOA NOVA,BA,0.881,0.119,6603,889,7492
2929370,SÃO JOSÉ DO JACUÍPE,BA,0.834,0.166,4467,886,5353
2901502,ANGUERA,BA,0.862,0.138,5502,883,6385
2903607,BIRITINGA,BA,0.906,0.094,8405,877,9282
2925600,PRESIDENTE DUTRA,BA,0.897,0.103,7605,874,8479
2904100,BOQUIRA,BA,0.92,0.08,10054,873,10927
2901304,ANDARAÍ,BA,0.875,0.125,6057,867,6924
2910008,DÁRIO MEIRA,BA,0.832,0.168,4273,865,5138
2928505,SANTA TEREZINHA,BA,0.846,0.154,4715,856,5571
2930808,SOUTO SOARES,BA,0.912,0.088,8807,854,9661
2921450,MIRANTE,BA,0.826,0.174,4000,842,4842
2910909,FIRMINO ALVES,BA,0.73,0.27,2258,836,3094
2902302,ARATUÍPE,BA,0.849,0.151,4635,827,5462
2920452,MANSIDÃO,BA,0.858,0.142,4908,811,5719
2910107,DOM BASÍLIO,BA,0.893,0.107,6708,805,7513
2907707,CHORROCHÓ,BA,0.87,0.13,5341,798,6139
2902203,ARAMARI,BA,0.876,0.124,5643,797,6440
2920809,MARCIONÍLIO SOUZA,BA,0.841,0.159,4191,793,4984
2918753,LAGOA REAL,BA,0.894,0.106,6647,792,7439
2911253,GAVIÃO,BA,0.729,0.271,2108,785,2893
2926509,RIBEIRA DO AMPARO,BA,0.9,0.1,7060,785,7845
2903003,BARRA DO MENDES,BA,0.908,0.092,7691,779,8470
2905503,CALDEIRÃO GRANDE,BA,0.883,0.117,5852,774,6626
2913309,ICHU,BA,0.809,0.191,3265,773,4038
2922805,NOVA ITARANA,BA,0.799,0.201,3042,765,3807
2923050,NOVO TRIUNFO,BA,0.846,0.154,4166,760,4926
2917904,JANDAÍRA,BA,0.855,0.145,4441,755,5196
2919058,LAJEDO DO TABOCAL,BA,0.821,0.179,3455,754,4209
2928307,SANTANÓPOLIS,BA,0.867,0.133,4881,751,5632
2910206,DOM MACEDO COSTA,BA,0.746,0.254,2162,738,2900
2915353,ITAGUAÇU DA BAHIA,BA,0.892,0.108,6050,736,6786
2901353,ANDORINHA,BA,0.921,0.079,8339,717,9056
2922052,MULUNGU DO MORRO,BA,0.904,0.096,6686,707,7393
2905107,CAÉM,BA,0.874,0.126,4839,695,5534
2923308,OURIÇANGAS,BA,0.839,0.161,3625,694,4319
2919306,LENÇÓIS,BA,0.863,0.137,4376,694,5070
2927903,SANTA INÊS,BA,0.873,0.127,4681,681,5362
2907558,CATURAMA,BA,0.867,0.133,4403,673,5076
2903102,BARRA DO ROCHA,BA,0.743,0.257,1901,657,2558
2927101,RODELAS,BA,0.861,0.139,4025,649,4674
2900900,ALMADINA,BA,0.801,0.199,2527,628,3155
2924207,PEDRO ALEXANDRE,BA,0.903,0.097,5800,623,6423
2914208,IRAJUBA,BA,0.832,0.168,3055,618,3673
2924900,PLANALTINO,BA,0.871,0.129,4010,593,4603
2918506,JUSSARA,BA,0.931,0.069,7998,592,8590
2905156,CAETANOS,BA,0.912,0.088,5974,573,6547
2923506,PALMEIRAS,BA,0.885,0.115,4331,562,4893
2911659,GUAJERU,BA,0.873,0.127,3851,560,4411
2919900,MACURURÉ,BA,0.868,0.132,3676,559,4235
2908804,CONTENDAS DO SINCORÁ,BA,0.795,0.205,2099,541,2640
2903953,BOM JESUS DA SERRA,BA,0.903,0.097,4964,534,5498
2921054,MATINA,BA,0.918,0.082,5915,529,6444
2907400,CATOLÂNDIA,BA,0.806,0.194,2118,511,2629
2911501,GONGOGI,BA,0.839,0.161,2629,505,3134
2915908,ITANAGRA,BA,0.868,0.132,3217,491,3708
2919108,LAMARÃO,BA,0.899,0.101,4325,487,4812
2900603,AIQUARA,BA,0.815,0.185,2096,475,2571
2907004,CARDEAL DA SILVA,BA,0.908,0.092,4410,448,4858
2909505,CRAVOLÂNDIA,BA,0.844,0.156,2251,416,2667
2931400,TEODORO SAMPAIO,BA,0.907,0.093,4008,409,4417
2918704,LAFAIETE COUTINHO,BA,0.858,0.142,2359,391,2750
2924108,PEDRÃO,BA,0.905,0.095,3584,378,3962
2922854,NOVA REDENÇÃO,BA,0.912,0.088,3836,369,4205
2919009,LAJEDINHO,BA,0.862,0.138,1938,309,2247
2912608,IBIQUERA,BA,0.869,0.131,1777,268,2045
2304400,FORTALEZA,CE,0.556,0.444,739265,590033,1329298
2303709,CAUCAIA,CE,0.633,0.367,107263,62133,169396
2307650,MARACANAÚ,CE,0.607,0.393,74823,48472,123295
2312908,SOBRAL,CE,0.669,0.331,69923,34651,104574
2307304,JUAZEIRO DO NORTE,CE,0.761,0.239,101288,31793,133081
2307700,MARANGUAPE,CE,0.69,0.31,40475,18147,58622
2305233,HORIZONTE,CE,0.665,0.335,26643,13407,40050
2311306,QUIXADÁ,CE,0.684,0.316,28670,13272,41942
2313401,TIANGUÁ,CE,0.67,0.33,26590,13126,39716
2301000,AQUIRAZ,CE,0.692,0.308,29499,13121,42620
2306405,ITAPIPOCA,CE,0.811,0.189,54153,12622,66775
2304285,EUSÉBIO,CE,0.609,0.391,19575,12560,32135
2309706,PACATUBA,CE,0.645,0.355,22267,12249,34516
2309607,PACAJUS,CE,0.674,0.326,24236,11715,35951
2301109,ARACATI,CE,0.716,0.284,28880,11455,40335
2303501,CASCAVEL,CE,0.719,0.281,28742,11211,39953
2311801,RUSSAS,CE,0.734,0.266,30874,11203,42077
2304202,CRATO,CE,0.846,0.154,59204,10784,69988
2312403,SÃO GONÇALO DO AMARANTE,CE,0.672,0.328,21207,10333,31540
2301901,BARBALHA,CE,0.739,0.261,25379,8953,34332
2305506,IGUATU,CE,0.828,0.172,42462,8806,51268
2308708,MORADA NOVA,CE,0.774,0.226,29611,8656,38267
2304103,CRATEÚS,CE,0.797,0.203,32592,8323,40915
2302602,CAMOCIM,CE,0.753,0.247,25255,8274,33529
2306306,ITAPAJÉ,CE,0.714,0.286,20248,8117,28365
2313302,TAUÁ,CE,0.733,0.267,21691,7921,29612
2302206,BEBERIBE,CE,0.758,0.242,22228,7113,29341
2307601,LIMOEIRO DO NORTE,CE,0.789,0.211,26481,7081,33562
2302800,CANINDÉ,CE,0.833,0.167,34530,6907,41437
2311405,QUIXERAMOBIM,CE,0.831,0.169,32322,6571,38893
2306256,ITAITINGA,CE,0.692,0.308,14614,6493,21107
2314102,VIÇOSA DO CEARÁ,CE,0.799,0.201,25585,6440,32025
2307809,MARCO,CE,0.599,0.401,9221,6175,15396
2300200,ACARAÚ,CE,0.794,0.206,23661,6154,29815
2310209,PARACURU,CE,0.733,0.267,16352,5963,22315
2313500,TRAIRI,CE,0.805,0.195,24614,5946,30560
2305407,ICÓ,CE,0.834,0.166,29416,5862,35278
2312304,SÃO BENEDITO,CE,0.771,0.229,19673,5830,25503
2310258,PARAIPABA,CE,0.682,0.318,12404,5796,18200
2308005,MASSAPÊ,CE,0.737,0.263,15280,5460,20740
2308104,MAURITI,CE,0.782,0.218,19565,5458,25023
2305001,GUARACIABA DO NORTE,CE,0.767,0.233,17067,5182,22249
2307007,JAGUARUANA,CE,0.738,0.262,14425,5117,19542
2306553,ITAREMA,CE,0.76,0.24,16100,5086,21186
2308906,MORRINHOS,CE,0.574,0.426,6766,5016,11782
2313609,UBAJARA,CE,0.719,0.281,12393,4837,17230
2310704,PENTECOSTE,CE,0.8,0.2,19234,4817,24051
2302503,BREJO SANTO,CE,0.821,0.179,21561,4703,26264
2310308,PARAMBU,CE,0.736,0.264,12140,4353,16493
2304251,CRUZ,CE,0.697,0.303,9882,4293,14175
2305803,IPU,CE,0.813,0.187,18089,4171,22260
2305902,IPUEIRAS,CE,0.789,0.211,15504,4150,19654
2312205,SANTA QUITÉRIA,CE,0.832,0.168,19557,3940,23497
2309300,NOVA RUSSAS,CE,0.752,0.248,11951,3936,15887
2304350,FORQUILHA,CE,0.709,0.291,9447,3871,13318
2300754,AMONTADA,CE,0.829,0.171,18328,3789,22117
2311603,REDENÇÃO,CE,0.778,0.222,13184,3772,16956
2302107,BATURITÉ,CE,0.809,0.191,15675,3707,19382
2309458,OCARA,CE,0.781,0.219,13020,3650,16670
2312700,SENADOR POMPEU,CE,0.747,0.253,10736,3634,14370
2300309,ACOPIARA,CE,0.867,0.133,23614,3629,27243
2314003,VÁRZEA ALEGRE,CE,0.839,0.161,18717,3596,22313
2304707,GRANJA,CE,0.885,0.115,27406,3557,30963
2306900,JAGUARIBE,CE,0.829,0.171,17204,3553,20757
2301208,ARACOIABA,CE,0.804,0.196,14469,3529,17998
2301950,BARREIRA,CE,0.733,0.267,9374,3413,12787
2313104,TABULEIRO DO NORTE,CE,0.815,0.185,14930,3380,18310
2308500,MOMBAÇA,CE,0.852,0.148,18968,3283,22251
2310852,PINDORETAMA,CE,0.754,0.246,10051,3272,13323
2305357,ICAPUÍ,CE,0.731,0.269,8792,3230,12022
2303204,CARIRIAÇU,CE,0.812,0.188,13592,3142,16734
2308401,MISSÃO VELHA,CE,0.853,0.147,18181,3141,21322
2302305,BELA CRUZ,CE,0.782,0.218,11141,3113,14254
2304954,GUAIÚBA,CE,0.794,0.206,11614,3022,14636
2312007,SANTANA DO ACARAÚ,CE,0.832,0.168,14893,3008,17901
2305308,IBIAPINA,CE,0.754,0.246,9176,2992,12168
2302404,BOA VIAGEM,CE,0.898,0.102,25403,2900,28303
2303956,CHOROZINHO,CE,0.769,0.231,9598,2879,12477
2303105,CARIRÉ,CE,0.721,0.279,7414,2865,10279
2313955,VARJOTA,CE,0.714,0.286,7079,2833,9912
2300150,ACARAPE,CE,0.678,0.322,5839,2769,8608
2313807,URUBURETAMA,CE,0.786,0.214,10062,2739,12801
2304459,FORTIM,CE,0.716,0.284,6831,2708,9539
2311504,QUIXERÉ,CE,0.787,0.213,9781,2645,12426
2305605,INDEPENDÊNCIA,CE,0.817,0.183,11782,2639,14421
2307254,JIJOCA DE JERICOACOARA,CE,0.754,0.246,8073,2631,10704
2304004,COREAÚ,CE,0.811,0.189,10974,2559,13533
2307403,JUCÁS,CE,0.814,0.186,10933,2503,13436
2310506,PEDRA BRANCA,CE,0.896,0.104,21268,2474,23742
2305209,HIDROLÂNDIA,CE,0.791,0.209,8618,2278,10896
2307502,LAVRAS DA MANGABEIRA,CE,0.865,0.135,14370,2237,16607
2303402,CARNAUBAL,CE,0.758,0.242,6827,2176,9003
2313203,TAMBORIL,CE,0.851,0.149,12380,2170,14550
2301703,AURORA,CE,0.856,0.144,12526,2110,14636
2303808,CEDRO,CE,0.859,0.141,12605,2066,14671
2307106,JARDIM,CE,0.863,0.137,12855,2047,14902
2309508,ORÓS,CE,0.842,0.158,10598,1986,12584
2304509,FRECHEIRINHA,CE,0.775,0.225,6818,1980,8798
2304905,GROAÍRAS,CE,0.684,0.316,4265,1972,6237
2313757,UMIRIM,CE,0.82,0.18,8904,1958,10862
2308203,MERUOCA,CE,0.767,0.233,6346,1928,8274
2313559,TURURU,CE,0.814,0.186,8370,1916,10286
2302701,CAMPOS SALES,CE,0.866,0.134,12132,1878,14010
2306108,IRAUÇUBA,CE,0.852,0.148,10821,1878,12699
2306504,ITAPIÚNA,CE,0.834,0.166,9161,1821,10982
2309409,NOVO ORIENTE,CE,0.881,0.119,13380,1813,15193
2310001,PALHANO,CE,0.713,0.287,4475,1798,6273
2308302,MILAGRES,CE,0.89,0.11,14447,1782,16229
2303006,CARIDADE,CE,0.852,0.148,9796,1698,11494
2302909,CAPISTRANO,CE,0.85,0.15,9534,1681,11215
2312601,SÃO LUÍS DO CURU,CE,0.793,0.207,6442,1680,8122
2311702,RERIUTABA,CE,0.838,0.162,8634,1665,10299
2306603,ITATIRA,CE,0.87,0.13,11040,1654,12694
2313351,TEJUÇUOCA,CE,0.85,0.15,9214,1624,10838
2303303,CARIÚS,CE,0.855,0.145,9428,1601,11029
2301604,ASSARÉ,CE,0.878,0.122,11387,1584,12971
2311355,QUIXELÔ,CE,0.85,0.15,8979,1580,10559
2304236,CROATÁ,CE,0.842,0.158,8377,1577,9954
2308609,MONSENHOR TABOSA,CE,0.848,0.152,8761,1576,10337
2311264,QUITERIANÓPOLIS,CE,0.857,0.143,9349,1562,10911
2304301,FARIAS BRITO,CE,0.87,0.13,10416,1552,11968
2309003,MUCAMBO,CE,0.819,0.181,6787,1504,8291
2300903,APUIARÉS,CE,0.832,0.168,7423,1501,8924
2305332,IBICUITINGA,CE,0.821,0.179,6823,1484,8307
2301406,ARATUBA,CE,0.818,0.182,6409,1427,7836
2305654,IPAPORANGA,CE,0.784,0.216,5121,1415,6536
2313906,URUOCA,CE,0.821,0.179,6424,1397,7821
2302008,BARRO,CE,0.882,0.118,10421,1391,11812
2311959,SALITRE,CE,0.854,0.146,8150,1389,9539
2301851,BANABUIÚ,CE,0.865,0.135,8841,1376,10217
2309201,NOVA OLINDA,CE,0.852,0.148,7890,1372,9262
2313005,SOLONÓPOLE,CE,0.86,0.14,8443,1371,9814
2310803,PEREIRO,CE,0.86,0.14,8301,1352,9653
2301257,ARARENDÁ,CE,0.78,0.22,4720,1332,6052
2306702,JAGUARETAMA,CE,0.874,0.126,8993,1294,10287
2310407,PARAMOTI,CE,0.815,0.185,5691,1289,6980
2310100,PALMÁCIA,CE,0.803,0.197,5120,1258,6378
2305266,IBARETAMA,CE,0.852,0.148,7174,1245,8419
2306009,IRACEMA,CE,0.849,0.151,6923,1232,8155
2302057,BARROQUINHA,CE,0.872,0.128,8284,1216,9500
2306207,ITAIÇABA,CE,0.761,0.239,3848,1209,5057
2307635,MADALENA,CE,0.877,0.123,8536,1200,9736
2309805,PACOTI,CE,0.839,0.161,6179,1187,7366
2311900,SABOEIRO,CE,0.865,0.135,7398,1153,8551
2300705,ALTO SANTO,CE,0.87,0.13,7572,1134,8706
2313708,UMARI,CE,0.752,0.248,3285,1085,4370
2309102,MULUNGU,CE,0.827,0.173,5021,1050,6071
2311108,PORTEIRAS,CE,0.894,0.106,8829,1047,9876
2308807,MORAÚJO,CE,0.805,0.195,4244,1028,5272
2301307,ARARIPE,CE,0.914,0.086,10887,1026,11913
2303907,CHAVAL,CE,0.869,0.131,6756,1016,7772
2310951,PIRES FERREIRA,CE,0.825,0.175,4564,970,5534
2303931,CHORÓ,CE,0.877,0.123,6714,938,7652
2310902,PIQUET CARNEIRO,CE,0.885,0.115,7134,927,8061
2304657,GRAÇA,CE,0.894,0.106,7600,905,8505
2312106,SANTANA DO CARIRI,CE,0.91,0.09,9102,899,10001
2300507,ALCÂNTARAS,CE,0.864,0.136,5599,883,6482
2306801,JAGUARIBARA,CE,0.849,0.151,4871,868,5739
2311009,PORANGA,CE,0.87,0.13,5778,867,6645
2307908,MARTINÓPOLE,CE,0.88,0.12,6177,846,7023
2304608,GENERAL SAMPAIO,CE,0.837,0.163,4308,836,5144
2308351,MILHÃ,CE,0.893,0.107,6894,829,7723
2310605,PENAFORTE,CE,0.859,0.141,5026,828,5854
2308377,MIRAÍMA,CE,0.897,0.103,7162,820,7982
2305704,IPAUMIRIM,CE,0.879,0.121,5964,819,6783
2312809,SENADOR SÁ,CE,0.815,0.185,3553,804,4357
2303600,CATARINA,CE,0.857,0.143,4691,780,5471
2303659,CATUNDA,CE,0.876,0.124,5242,744,5986
2312502,SÃO JOÃO DO JAGUARIBE,CE,0.846,0.154,4079,742,4821
2300101,ABAIARA,CE,0.873,0.127,4665,681,5346
2301505,ARNEIROZ,CE,0.85,0.15,3742,659,4401
2300408,AIUABA,CE,0.915,0.085,7000,654,7654
2305100,GUARAMIRANGA,CE,0.847,0.153,3479,628,4107
2307205,JATI,CE,0.881,0.119,4325,583,4908
2313252,TARRAFAS,CE,0.903,0.097,4730,508,5238
2304277,ERERÊ,CE,0.859,0.141,3094,506,3600
2311207,POTENGI,CE,0.905,0.095,4750,500,5250
2309904,PACUJÁ,CE,0.877,0.123,3573,499,4072
2300804,ANTONINA DO NORTE,CE,0.89,0.11,3905,481,4386
2304269,DEPUTADO IRAPUAN PINHEIRO,CE,0.912,0.088,4638,448,5086
2300606,ALTANEIRA,CE,0.902,0.098,3999,435,4434
2311231,POTIRETAMA,CE,0.892,0.108,3579,433,4012
2304806,GRANJEIRO,CE,0.887,0.113,3375,430,3805
2301802,BAIXIO,CE,0.893,0.107,3487,419,3906
5300108,BRASÍLIA,DF,0.3,0.7,463340,1080411,1543751
3205200,VILA VELHA,ES,0.318,0.682,77613,166300,243913
3205002,SERRA,ES,0.417,0.583,98707,137878,236585
3205309,VITÓRIA,ES,0.368,0.632,72064,123734,195798
3201308,CARIACICA,ES,0.396,0.604,76814,117219,194033
3201209,CACHOEIRO DE ITAPEMIRIM,ES,0.247,0.753,24792,75462,100254
3203205,LINHARES,ES,0.341,0.659,26360,51015,77375
3201506,COLATINA,ES,0.277,0.723,17848,46700,64548
3202405,GUARAPARI,ES,0.279,0.721,17993,46417,64410
3200607,ARACRUZ,ES,0.372,0.628,18253,30832,49085
3204906,SÃO MATEUS,ES,0.479,0.521,27104,29517,56621
3205101,VIANA,ES,0.406,0.594,14884,21818,36702
3204559,SANTA MARIA DE JETIBÁ,ES,0.259,0.741,5721,16375,22096
3201407,CASTELO,ES,0.202,0.798,4124,16286,20410
3201902,DOMINGOS MARTINS,ES,0.233,0.767,4831,15930,20761
3202801,ITAPEMIRIM,ES,0.322,0.678,7489,15785,23274
3203908,NOVA VENÉCIA,ES,0.442,0.558,11649,14677,26326
3203320,MARATAÍZES,ES,0.292,0.708,5766,13957,19723
3200904,BARRA DE SÃO FRANCISCO,ES,0.435,0.565,9975,12932,22907
3204708,SÃO GABRIEL DA PALHA,ES,0.385,0.615,6890,11016,17906
3200102,AFONSO CLÁUDIO,ES,0.364,0.636,6007,10484,16491
3205069,VENDA NOVA DO IMIGRANTE,ES,0.19,0.81,2428,10375,12803
3200805,BAIXO GUANDU,ES,0.358,0.642,5739,10313,16052
3200409,ANCHIETA,ES,0.362,0.638,5813,10240,16053
3204609,SANTA TERESA,ES,0.263,0.737,3606,10121,13727
3203007,IÚNA,ES,0.311,0.689,4398,9747,14145
3202306,GUAÇUÍ,ES,0.339,0.661,4887,9516,14403
3200201,ALEGRE,ES,0.417,0.583,6621,9243,15864
3202454,IBATIBA,ES,0.318,0.682,4037,8640,12677
3205036,VARGEM ALTA,ES,0.228,0.772,2526,8568,11094
3204203,PIÚMA,ES,0.344,0.656,3855,7339,11194
3203403,MIMOSO DO SUL,ES,0.497,0.503,7031,7119,14150
3200300,ALFREDO CHAVES,ES,0.212,0.788,1835,6816,8651
3203346,MARECHAL FLORIANO,ES,0.292,0.708,2775,6734,9509
3205010,SOORETAMA,ES,0.491,0.509,6269,6491,12760
3203056,JAGUARÉ,ES,0.579,0.421,8841,6435,15276
3203130,JOÃO NEIVA,ES,0.332,0.668,3142,6311,9453
3202108,ECOPORANGA,ES,0.539,0.461,6912,5903,12815
3204351,RIO BANANAL,ES,0.443,0.557,4689,5902,10591
3203700,MUNIZ FREIRE,ES,0.396,0.604,3833,5841,9674
3204005,PANCAS,ES,0.454,0.546,4842,5812,10654
3202207,FUNDÃO,ES,0.425,0.575,4262,5768,10030
3202603,ICONHA,ES,0.308,0.692,2484,5571,8055
3201605,CONCEIÇÃO DA BARRA,ES,0.607,0.393,8355,5405,13760
3204302,PRESIDENTE KENNEDY,ES,0.378,0.622,3272,5378,8650
3204104,PINHEIROS,ES,0.589,0.411,7275,5077,12352
3204401,RIO NOVO DO SUL,ES,0.248,0.752,1638,4974,6612
3203353,MARILÂNDIA,ES,0.335,0.665,2505,4974,7479
3201704,CONCEIÇÃO DO CASTELO,ES,0.237,0.763,1539,4950,6489
3202652,IRUPI,ES,0.313,0.687,2190,4799,6989
3204054,PEDRO CANÁRIO,ES,0.582,0.418,6658,4783,11441
3202702,ITAGUAÇU,ES,0.413,0.587,3314,4708,8022
3204955,SÃO ROQUE DO CANAÃ,ES,0.333,0.667,2334,4675,7009
3202900,ITARANA,ES,0.311,0.689,2098,4652,6750
3203809,MUQUI,ES,0.437,0.563,3501,4508,8009
3202504,IBIRAÇU,ES,0.345,0.655,2349,4461,6810
3203502,MONTANHA,ES,0.553,0.447,5351,4330,9681
3203163,LARANJA DA TERRA,ES,0.362,0.638,2444,4314,6758
3203304,MANTENÓPOLIS,ES,0.406,0.594,2945,4304,7249
3203106,JERÔNIMO MONTEIRO,ES,0.376,0.624,2505,4159,6664
3204500,SANTA LEOPOLDINA,ES,0.432,0.568,3094,4066,7160
3205176,VILA VALÉRIO,ES,0.558,0.442,4985,3953,8938
3200706,ATÍLIO VIVACQUA,ES,0.425,0.575,2762,3733,6495
3201001,BOA ESPERANÇA,ES,0.514,0.486,3897,3690,7587
3200169,ÁGUA DOCE DO NORTE,ES,0.53,0.47,3822,3386,7208
3201159,BREJETUBA,ES,0.456,0.544,2725,3247,5972
3202256,GOVERNADOR LINDENBERG,ES,0.484,0.516,2972,3174,6146
3202553,IBITIRAMA,ES,0.374,0.626,1792,3003,4795
3204807,SÃO JOSÉ DO CALÇADO,ES,0.488,0.512,2850,2994,5844
3201100,BOM JESUS DO NORTE,ES,0.416,0.584,2065,2903,4968
3204658,SÃO DOMINGOS DO NORTE,ES,0.492,0.508,2678,2765,5443
3205150,VILA PAVÃO,ES,0.518,0.482,2845,2650,5495
3200136,ÁGUIA BRANCA,ES,0.585,0.415,3528,2504,6032
3202009,DORES DO RIO PRETO,ES,0.445,0.555,1810,2254,4064
3200508,APIACÁ,ES,0.458,0.542,1897,2243,4140
3200359,ALTO RIO NOVO,ES,0.539,0.461,2315,1979,4294
3201803,DIVINO DE SÃO LOURENÇO,ES,0.376,0.624,1015,1685,2700
3204252,PONTO BELO,ES,0.641,0.359,2638,1475,4113
3203601,MUCURICI,ES,0.614,0.386,2096,1317,3413
5208707,GOIÂNIA,GO,0.258,0.742,183731,528525,712256
5201108,ANÁPOLIS,GO,0.203,0.797,39442,154907,194349
5201405,APARECIDA DE GOIÂNIA,GO,0.33,0.67,71561,145366,216927
5218805,RIO VERDE,GO,0.329,0.671,31363,64085,95448
5212501,LUZIÂNIA,GO,0.322,0.678,27501,58032,85533
5221403,TRINDADE,GO,0.333,0.667,19604,39180,58784
5221858,VALPARAÍSO DE GOIÁS,GO,0.349,0.651,20509,38332,58841
5200258,ÁGUAS LINDAS DE GOIÁS,GO,0.422,0.578,27817,38057,65874
5211503,ITUMBIARA,GO,0.324,0.676,16542,34589,51131
5220454,SENADOR CANEDO,GO,0.375,0.625,19197,31951,51148
5208004,FORMOSA,GO,0.387,0.613,19936,31609,51545
5211909,JATAÍ,GO,0.346,0.654,16570,31326,47896
5204508,CALDAS NOVAS,GO,0.279,0.721,11573,29977,41550
5205109,CATALÃO,GO,0.427,0.573,21312,28634,49946
5208608,GOIANÉSIA,GO,0.364,0.636,13307,23211,36518
5217609,PLANALTINA,GO,0.423,0.577,16631,22659,39290
5215231,NOVO GAMA,GO,0.374,0.626,11971,20034,32005
5213103,MINEIROS,GO,0.381,0.619,11335,18443,29778
5210000,INHUMAS,GO,0.351,0.649,9838,18186,28024
5219753,SANTO ANTÔNIO DO DESCOBERTO,GO,0.365,0.635,10306,17921,28227
5205497,CIDADE OCIDENTAL,GO,0.376,0.624,10624,17644,28268
5211800,JARAGUÁ,GO,0.244,0.756,5483,16996,22479
5213806,MORRINHOS,GO,0.336,0.664,8178,16158,24336
5206206,CRISTALINA,GO,0.323,0.677,7459,15610,23069
5208806,GOIANIRA,GO,0.361,0.639,8161,14468,22629
5218508,QUIRINÓPOLIS,GO,0.42,0.58,9923,13693,23616
5220108,SÃO LUÍS DE MONTES BELOS,GO,0.227,0.773,3838,13093,16931
5209101,GOIATUBA,GO,0.294,0.706,5328,12780,18108
5219308,SANTA HELENA DE GOIÁS,GO,0.418,0.582,8692,12118,20810
5210406,ITABERAÍ,GO,0.438,0.562,9395,12060,21455
5218003,PORANGATU,GO,0.446,0.554,9612,11934,21546
5221601,URUAÇU,GO,0.407,0.593,7855,11467,19322
5210208,IPORÁ,GO,0.38,0.62,6777,11074,17851
5217401,PIRES DO RIO,GO,0.277,0.723,4136,10771,14907
5203302,BELA VISTA DE GOIÁS,GO,0.33,0.67,4976,10089,15065
5214507,NERÓPOLIS,GO,0.347,0.653,5233,9868,15101
5214606,NIQUELÂNDIA,GO,0.454,0.546,8189,9865,18054
5215702,PALMEIRAS DE GOIÁS,GO,0.314,0.686,4454,9745,14199
5200308,ALEXÂNIA,GO,0.29,0.71,3979,9723,13702
5205406,CERES,GO,0.292,0.708,3531,8541,12072
5217104,PIRACANJUBA,GO,0.363,0.637,4833,8475,13308
5217302,PIRENÓPOLIS,GO,0.385,0.615,5235,8368,13603
5210109,IPAMERI,GO,0.396,0.604,5486,8356,13842
5218300,POSSE,GO,0.505,0.495,8402,8222,16624
5211206,ITAPURANGA,GO,0.472,0.528,7224,8082,15306
5218904,RUBIATABA,GO,0.264,0.736,2868,7982,10850
5213087,MINAÇU,GO,0.468,0.532,6986,7944,14930
5215603,PADRE BERNARDO,GO,0.4,0.6,5051,7591,12642
5209705,HIDROLÂNDIA,GO,0.359,0.641,4099,7323,11422
5220603,SILVÂNIA,GO,0.363,0.637,4049,7116,11165
5220207,SÃO MIGUEL DO ARAGUAIA,GO,0.417,0.583,5022,7009,12031
5201306,ANICUNS,GO,0.333,0.667,3453,6906,10359
5203500,BOM JESUS DE GOIÁS,GO,0.412,0.588,4667,6665,11332
5205513,COCALZINHO DE GOIÁS,GO,0.36,0.64,3718,6608,10326
5208905,GOIÁS,GO,0.523,0.477,6957,6345,13302
5217708,PONTALINA,GO,0.369,0.631,3646,6222,9868
5212204,JUSSARA,GO,0.388,0.612,3863,6082,9945
5200134,ACREÚNA,GO,0.414,0.586,4278,6063,10341
5210901,ITAPACI,GO,0.445,0.555,4651,5798,10449
5208400,GOIANÁPOLIS,GO,0.241,0.759,1807,5695,7502
5222005,VIANÓPOLIS,GO,0.282,0.718,2167,5515,7682
5215306,ORIZONA,GO,0.348,0.652,2934,5494,8428
5209200,GUAPÓ,GO,0.397,0.603,3471,5273,8744
5200100,ABADIÂNIA,GO,0.255,0.745,1781,5204,6985
5204409,CAIAPÔNIA,GO,0.434,0.566,3814,4970,8784
5201702,ARAGARÇAS,GO,0.419,0.581,3557,4941,8498
5204300,CAÇU,GO,0.345,0.655,2429,4610,7039
5213756,MONTIVIDIU,GO,0.297,0.703,1898,4496,6394
5218607,RIALMA,GO,0.283,0.717,1757,4457,6214
5220405,SÃO SIMÃO,GO,0.548,0.452,5336,4395,9731
5214002,MOZARLÂNDIA,GO,0.397,0.603,2891,4384,7275
5207808,FIRMINÓPOLIS,GO,0.262,0.738,1550,4372,5922
5221700,URUANA,GO,0.385,0.615,2704,4321,7025
5200050,ABADIA DE GOIÁS,GO,0.31,0.69,1928,4285,6213
5209952,INDIARA,GO,0.455,0.545,3531,4236,7767
5204706,CAMPINORTE,GO,0.329,0.671,2071,4217,6288
5207402,EDÉIA,GO,0.382,0.618,2566,4148,6714
5206404,CRIXÁS,GO,0.54,0.46,4654,3964,8618
5216809,PETROLINA DE GOIÁS,GO,0.291,0.709,1540,3748,5288
5216403,PARAÚNA,GO,0.378,0.622,2252,3701,5953
5205471,CHAPADÃO DO CÉU,GO,0.31,0.69,1652,3672,5324
5204904,CAMPOS BELOS,GO,0.607,0.393,5442,3526,8968
5201801,ARAGOIÂNIA,GO,0.366,0.634,2027,3509,5536
5203906,BURITI ALEGRE,GO,0.36,0.64,1907,3396,5303
5203203,BARRO ALTO,GO,0.433,0.567,2587,3382,5969
5217203,PIRANHAS,GO,0.482,0.518,3133,3363,6496
5215009,NOVA VENEZA,GO,0.387,0.613,2085,3297,5382
5205000,CARMO DO RIO VERDE,GO,0.374,0.626,1929,3228,5157
5214408,NAZÁRIO,GO,0.34,0.66,1664,3228,4892
5205802,CORUMBÁ DE GOIÁS,GO,0.356,0.644,1781,3221,5002
5211404,ITAUÇU,GO,0.368,0.632,1809,3109,4918
5219001,SANCLERLÂNDIA,GO,0.38,0.62,1852,3023,4875
5205455,CEZARINA,GO,0.405,0.595,2025,2979,5004
5215504,OUVIDOR,GO,0.46,0.54,2497,2937,5434
5212808,MARA ROSA,GO,0.463,0.537,2457,2847,5304
5204102,CACHOEIRA ALTA,GO,0.466,0.534,2448,2806,5254
5204854,CAMPO LIMPO DE GOIÁS,GO,0.312,0.688,1259,2772,4031
5213707,MONTES CLAROS DE GOIÁS,GO,0.411,0.589,1922,2756,4678
5221197,TEREZÓPOLIS DE GOIÁS,GO,0.373,0.627,1630,2735,4365
5205901,CORUMBAÍBA,GO,0.388,0.612,1691,2666,4357
5211701,JANDAIA,GO,0.344,0.656,1389,2650,4039
5214861,NOVA GLÓRIA,GO,0.429,0.571,1957,2607,4564
5213004,MAURILÂNDIA,GO,0.487,0.513,2475,2603,5078
5214838,NOVA CRIXÁS,GO,0.554,0.446,3206,2586,5792
5203559,BONFINÓPOLIS,GO,0.396,0.604,1677,2563,4240
5212303,LEOPOLDO DE BULHÕES,GO,0.399,0.601,1631,2457,4088
5219100,SANTA BÁRBARA DE GOIÁS,GO,0.366,0.634,1411,2439,3850
5200555,ALTO HORIZONTE,GO,0.363,0.637,1386,2429,3815
5222054,VICENTINÓPOLIS,GO,0.427,0.573,1808,2428,4236
5216304,PARANAIGUARA,GO,0.521,0.479,2638,2424,5062
5219738,SANTO ANTÔNIO DE GOIÁS,GO,0.372,0.628,1433,2422,3855
5211008,ITAPIRAPUÃ,GO,0.495,0.505,2338,2382,4720
5212105,JOVIÂNIA,GO,0.386,0.614,1481,2351,3832
5212709,MAMBAÍ,GO,0.427,0.573,1668,2241,3909
5221502,TURVÂNIA,GO,0.307,0.693,992,2237,3229
5219704,SANTA TEREZINHA DE GOIÁS,GO,0.571,0.429,2972,2230,5202
5207253,DOVERLÂNDIA,GO,0.497,0.503,2126,2154,4280
5204250,CACHOEIRA DOURADA,GO,0.544,0.456,2563,2146,4709
5219902,SÃO FRANCISCO DE GOIÁS,GO,0.326,0.674,1036,2146,3182
5220504,SERRANÓPOLIS,GO,0.458,0.542,1813,2142,3955
5200803,ALVORADA DO NORTE,GO,0.502,0.498,2083,2066,4149
5202502,ARUANÃ,GO,0.454,0.546,1697,2038,3735
5203401,BOM JARDIM DE GOIÁS,GO,0.562,0.438,2600,2027,4627
5210604,ITAGUARU,GO,0.473,0.527,1817,2023,3840
5207600,FAZENDA NOVA,GO,0.422,0.578,1474,2019,3493
5220009,SÃO JOÃO D'ALIANÇA,GO,0.544,0.456,2407,2015,4422
5209903,IACIARA,GO,0.61,0.39,3117,1994,5111
5202155,ARAGUAPAZ,GO,0.51,0.49,2058,1980,4038
5215900,PALMINÓPOLIS,GO,0.295,0.705,812,1944,2756
5200852,AMERICANO DO BRASIL,GO,0.446,0.554,1559,1934,3493
5204805,CAMPO ALEGRE DE GOIÁS,GO,0.462,0.538,1623,1893,3516
5204003,CABECEIRAS,GO,0.546,0.454,2275,1889,4164
5218706,RIANÁPOLIS,GO,0.283,0.717,746,1887,2633
5200175,ÁGUA FRIA DE GOIÁS,GO,0.354,0.646,1025,1868,2893
5210562,ITAGUARI,GO,0.447,0.553,1479,1831,3310
5207352,EDEALINA,GO,0.343,0.657,937,1796,2733
5203807,BRITÂNIA,GO,0.406,0.594,1221,1790,3011
5207907,FLORES DE GOIÁS,GO,0.577,0.423,2430,1779,4209
5215405,OURO VERDE DE GOIÁS,GO,0.3,0.7,758,1765,2523
5221007,TAQUARAL DE GOIÁS,GO,0.385,0.615,1102,1759,2861
5207535,FAINA,GO,0.588,0.412,2473,1736,4209
5201603,ARAÇU,GO,0.402,0.598,1144,1702,2846
5221908,VARJÃO,GO,0.305,0.695,744,1696,2440
5219803,SÃO DOMINGOS,GO,0.625,0.375,2792,1672,4464
5205208,CATURAÍ,GO,0.453,0.547,1368,1650,3018
5219407,SANTA RITA DO ARAGUAIA,GO,0.435,0.565,1260,1636,2896
5211305,ITARUMÃ,GO,0.443,0.557,1301,1634,2935
5218789,RIO QUENTE,GO,0.322,0.678,773,1627,2400
5214051,MUNDO NOVO,GO,0.504,0.496,1615,1591,3206
5222302,VILA PROPÍCIO,GO,0.505,0.495,1608,1575,3183
5206503,CROMÍNIA,GO,0.35,0.65,846,1570,2416
5206305,CRISTIANÓPOLIS,GO,0.314,0.686,717,1563,2280
5219357,SANTA ISABEL,GO,0.371,0.629,906,1533,2439
5213905,MOSSÂMEDES,GO,0.53,0.47,1696,1507,3203
5220686,SIMOLÂNDIA,GO,0.582,0.418,2092,1505,3597
5206800,DAMOLÂNDIA,GO,0.344,0.656,787,1503,2290
5208509,GOIANDIRA,GO,0.507,0.493,1522,1478,3000
5210802,ITAJÁ,GO,0.389,0.611,940,1475,2415
5221551,TURVELÂNDIA,GO,0.532,0.468,1655,1458,3113
5202809,AVELINÓPOLIS,GO,0.336,0.664,737,1455,2192
5200605,ALTO PARAÍSO DE GOIÁS,GO,0.621,0.379,2379,1454,3833
5220264,SÃO MIGUEL DO PASSA QUATRO,GO,0.429,0.571,1082,1441,2523
5204607,CAMPESTRE DE GOIÁS,GO,0.427,0.573,1069,1436,2505
5203939,BURITI DE GOIÁS,GO,0.292,0.708,584,1419,2003
5208301,DIVINÓPOLIS DE GOIÁS,GO,0.597,0.403,2102,1418,3520
5200902,AMORINÓPOLIS,GO,0.456,0.544,1172,1398,2570
5200159,ADELÂNDIA,GO,0.237,0.763,430,1387,1817
5203609,BRAZABRANTES,GO,0.355,0.645,762,1383,2145
5205703,CÓRREGO DO OURO,GO,0.229,0.771,409,1377,1786
5209606,HEITORAÍ,GO,0.453,0.547,1126,1358,2484
5204557,CALDAZINHA,GO,0.357,0.643,752,1354,2106
5214101,MUTUNÓPOLIS,GO,0.426,0.574,998,1347,2345
5220157,SÃO LUIZ DO NORTE,GO,0.517,0.483,1432,1339,2771
5215207,NOVO BRASIL,GO,0.419,0.581,965,1339,2304
5208152,GAMELEIRA DE GOIÁS,GO,0.395,0.605,862,1322,2184
5219258,SANTA FÉ DE GOIÁS,GO,0.463,0.537,1130,1311,2441
5219712,SANTO ANTÔNIO DA BARRA,GO,0.538,0.462,1508,1294,2802
5209150,GOUVELÂNDIA,GO,0.521,0.479,1400,1286,2686
5209937,INACIOLÂNDIA,GO,0.581,0.419,1751,1265,3016
5212956,MATRINCHÃ,GO,0.485,0.515,1186,1257,2443
5206701,DAMIANÓPOLIS,GO,0.456,0.544,1051,1253,2304
5219506,SANTA ROSA DE GOIÁS,GO,0.399,0.601,828,1249,2077
5208103,FORMOSO,GO,0.562,0.438,1588,1237,2825
5206909,DAVINÓPOLIS,GO,0.522,0.478,1338,1225,2563
5212055,JESÚPOLIS,GO,0.273,0.727,454,1212,1666
5213855,MORRO AGUDO DE GOIÁS,GO,0.347,0.653,637,1198,1835
5209804,HIDROLINA,GO,0.497,0.503,1179,1194,2373
5215652,PALESTINA DE GOIÁS,GO,0.439,0.561,932,1193,2125
5221809,URUTAÍ,GO,0.426,0.574,887,1193,2080
5221304,TRÊS RANCHOS,GO,0.5,0.5,1182,1183,2365
5210158,IPIRANGA DE GOIÁS,GO,0.394,0.606,762,1173,1935
5201504,APORÉ,GO,0.448,0.552,912,1124,2036
5219209,SANTA CRUZ DE GOIÁS,GO,0.398,0.602,742,1123,1865
5214879,NOVA IGUAÇU DE GOIÁS,GO,0.424,0.576,808,1097,1905
5220280,SÃO PATRÍCIO,GO,0.312,0.688,492,1087,1579
5219605,SANTA TEREZA DE GOIÁS,GO,0.463,0.537,934,1084,2018
5207501,ESTRELA DO NORTE,GO,0.471,0.529,965,1083,2048
5215256,NOVO PLANALTO,GO,0.54,0.46,1268,1079,2347
5205059,CASTELÂNDIA,GO,0.54,0.46,1262,1073,2335
5218052,PORTEIRÃO,GO,0.463,0.537,922,1070,1992
5202601,AURILÂNDIA,GO,0.537,0.463,1230,1060,2290
5218391,PROFESSOR JAMIL,GO,0.474,0.526,948,1054,2002
5218102,PORTELÂNDIA,GO,0.519,0.481,1131,1050,2181
5214705,NOVA AMÉRICA,GO,0.332,0.668,520,1048,1568
5202353,ARENÓPOLIS,GO,0.529,0.471,1157,1031,2188
5212600,MAIRIPOTABA,GO,0.352,0.648,548,1011,1559
5219456,SANTA RITA DO NOVO DESTINO,GO,0.482,0.518,932,1000,1932
5213509,MONTE ALEGRE DE GOIÁS,GO,0.708,0.292,2402,993,3395
5213772,MONTIVIDIU DO NORTE,GO,0.562,0.438,1272,991,2263
5213053,MIMOSO DE GOIÁS,GO,0.47,0.53,872,984,1856
5209291,GUARAÍTA,GO,0.47,0.53,859,968,1827
5210307,ISRAELÂNDIA,GO,0.459,0.541,821,968,1789
5215801,PALMELO,GO,0.358,0.642,533,957,1490
5216452,PEROLÂNDIA,GO,0.512,0.488,995,950,1945
5216908,PILAR DE GOIÁS,GO,0.521,0.479,1027,946,1973
5209408,GUARANI DE GOIÁS,GO,0.639,0.361,1676,946,2622
5207105,DIORAMA,GO,0.391,0.609,605,941,1546
5212006,JAUPACI,GO,0.492,0.508,907,936,1843
5216007,PANAMÁ,GO,0.434,0.566,712,928,1640
5203962,BURITINÓPOLIS,GO,0.56,0.44,1166,917,2083
5220058,SÃO JOÃO DA PARAÚNA,GO,0.322,0.678,431,908,1339
5221452,TROMBAS,GO,0.522,0.478,987,905,1892
5204656,CAMPINAÇU,GO,0.532,0.468,1029,904,1933
5201454,APARECIDA DO RIO DOCE,GO,0.49,0.51,838,873,1711
5211602,IVOLÂNDIA,GO,0.514,0.486,916,865,1781
5200209,ÁGUA LIMPA,GO,0.403,0.597,580,859,1439
5212907,MARZAGÃO,GO,0.431,0.569,639,842,1481
5213400,MOIPORÁ,GO,0.365,0.635,478,831,1309
5200829,AMARALINA,GO,0.597,0.403,1204,813,2017
5200506,ALOÂNDIA,GO,0.387,0.613,506,801,1307
5206602,CUMARI,GO,0.555,0.445,997,799,1796
5203575,BONÓPOLIS,GO,0.614,0.386,1234,777,2011
5222203,VILA BOA,GO,0.693,0.307,1631,721,2352
5214804,NOVA AURORA,GO,0.489,0.511,678,709,1387
5204953,CAMPOS VERDES,GO,0.726,0.274,1865,704,2569
5221577,UIRAPURU,GO,0.602,0.398,996,659,1655
5204201,CACHOEIRA DE GOIÁS,GO,0.445,0.555,520,649,1169
5205307,CAVALCANTE,GO,0.847,0.153,3484,627,4111
5220702,SÍTIO D'ABADIA,GO,0.63,0.37,1034,607,1641
5203104,BALIZA,GO,0.652,0.348,1104,589,1693
5212253,LAGOA SANTA,GO,0.369,0.631,343,587,930
5214903,NOVA ROMA,GO,0.679,0.321,1159,549,1708
5205521,COLINAS DO SUL,GO,0.725,0.275,1424,539,1963
5209457,GUARINOS,GO,0.642,0.358,964,537,1501
5221080,TERESINA DE GOIÁS,GO,0.702,0.298,1085,461,1546
5201207,ANHANGUERA,GO,0.511,0.489,391,374,765
2111300,SÃO LUÍS,MA,0.578,0.422,306690,224108,530798
2105302,IMPERATRIZ,MA,0.45,0.55,58054,70936,128990
2100055,AÇAILÂNDIA,MA,0.485,0.515,25808,27430,53238
2111201,SÃO JOSÉ DE RIBAMAR,MA,0.655,0.345,49761,26235,75996
2112209,TIMON,MA,0.74,0.26,62087,21797,83884
2101400,BALSAS,MA,0.551,0.449,23547,19170,42717
2103000,CAXIAS,MA,0.759,0.241,58289,18488,76777
2107506,PAÇO DO LUMIAR,MA,0.624,0.376,30503,18343,48846
2101202,BACABAL,MA,0.666,0.334,30586,15311,45897
2109908,SANTA INÊS,MA,0.684,0.316,28127,12991,41118
2101608,BARRA DO CORDA,MA,0.709,0.291,28593,11710,40303
2103307,CODÓ,MA,0.774,0.226,39224,11473,50697
2104800,GRAJAÚ,MA,0.7,0.3,22150,9502,31652
2108603,PINHEIRO,MA,0.771,0.229,29419,8749,38168
2103604,COROATÁ,MA,0.723,0.277,22054,8436,30490
2103208,CHAPADINHA,MA,0.78,0.22,29774,8385,38159
2105708,LAGO DA PEDRA,MA,0.64,0.36,14504,8142,22646
2102325,BURITICUPU,MA,0.747,0.253,21505,7300,28805
2108207,PEDREIRAS,MA,0.66,0.34,13147,6758,19905
2104057,ESTREITO,MA,0.606,0.394,9599,6238,15837
2109106,PRESIDENTE DUTRA,MA,0.714,0.286,13964,5581,19545
2110708,SÃO DOMINGOS DO MARANHÃO,MA,0.705,0.295,13118,5483,18601
2105401,ITAPECURU MIRIM,MA,0.827,0.173,25857,5407,31264
2110005,SANTA LUZIA,MA,0.831,0.169,26299,5352,31651
2112803,VIANA,MA,0.788,0.212,19698,5289,24987
2100600,AMARANTE DO MARANHÃO,MA,0.706,0.294,12451,5186,17637
2105427,ITINGA DO MARANHÃO,MA,0.574,0.426,6602,4905,11507
2101707,BARREIRINHAS,MA,0.843,0.157,26149,4877,31026
2114007,ZÉ DOCA,MA,0.79,0.21,17495,4658,22153
2109007,PORTO FRANCO,MA,0.639,0.361,7740,4369,12109
2112308,TUNTUM,MA,0.756,0.244,13549,4365,17914
2105500,JOÃO LISBOA,MA,0.687,0.313,9181,4185,13366
2109601,ROSÁRIO,MA,0.804,0.196,16994,4140,21134
2112506,TUTÓIA,MA,0.837,0.163,20863,4055,24918
2102804,CAROLINA,MA,0.65,0.35,7481,4032,11513
2103406,COELHO NETO,MA,0.839,0.161,19510,3734,23244
2113009,VITORINO FREIRE,MA,0.772,0.228,12628,3722,16350
2109452,RAPOSA,MA,0.727,0.273,9840,3693,13533
2104552,GOVERNADOR EDISON LOBÃO,MA,0.628,0.372,6128,3627,9755
2103802,DOM PEDRO,MA,0.705,0.295,8585,3588,12173
2111508,SÃO MATEUS DO MARANHÃO,MA,0.81,0.19,14805,3483,18288
2112233,TRIZIDELA DO VALE,MA,0.692,0.308,7680,3426,11106
2102036,BOM JESUS DAS SELVAS,MA,0.739,0.261,9651,3412,13063
2108504,PINDARÉ-MIRIM,MA,0.803,0.197,13705,3370,17075
2112902,VITÓRIA DO MEARIM,MA,0.795,0.205,13071,3367,16438
2101004,ARARI,MA,0.787,0.213,12390,3346,15736
2102002,BOM JARDIM,MA,0.821,0.179,14225,3095,17320
2112704,VARGEM GRANDE,MA,0.853,0.147,17890,3081,20971
2100956,ARAME,MA,0.787,0.213,11202,3040,14242
2111607,SÃO RAIMUNDO DAS MANGABEIRAS,MA,0.697,0.303,6857,2985,9842
2103505,COLINAS,MA,0.843,0.157,15648,2917,18565
2110500,SÃO BENTO,MA,0.834,0.166,14591,2907,17498
2102903,CARUTAPERA,MA,0.741,0.259,8274,2893,11167
2111102,SÃO JOÃO DOS PATOS,MA,0.779,0.221,10007,2841,12848
2111805,SÍTIO NOVO,MA,0.728,0.272,7484,2800,10284
2103752,DAVINÓPOLIS,MA,0.652,0.348,5126,2739,7865
2110203,SANTA RITA,MA,0.835,0.165,13813,2720,16533
2104099,FORMOSA DA SERRA NEGRA,MA,0.697,0.303,6215,2707,8922
2109809,SANTA HELENA,MA,0.819,0.181,12055,2667,14722
2102101,BREJO,MA,0.833,0.167,13236,2663,15899
2110039,SANTA LUZIA DO PARUÁ,MA,0.767,0.233,8679,2640,11319
2104677,GOVERNADOR NUNES FREIRE,MA,0.764,0.236,8543,2633,11176
2100907,ARAIOSES,MA,0.887,0.113,19425,2476,21901
2102358,BURITIRANA,MA,0.687,0.313,5179,2363,7542
2112407,TURIAÇU,MA,0.86,0.14,14412,2348,16760
2109502,RIACHÃO,MA,0.78,0.22,8274,2330,10604
2110302,SANTO ANTÔNIO DOS LOPES,MA,0.762,0.238,7425,2324,9749
2108108,PAULO RAMOS,MA,0.784,0.216,8221,2262,10483
2106326,MARACAÇUMÉ,MA,0.759,0.241,7034,2229,9263
2106755,MIRANDA DO NORTE,MA,0.784,0.216,8016,2209,10225
2103703,CURURUPU,MA,0.852,0.148,12685,2196,14881
2110609,SÃO BERNARDO,MA,0.845,0.155,11827,2167,13994
2106508,MATINHA,MA,0.829,0.171,10451,2162,12613
2108900,POÇÃO DE PEDRAS,MA,0.79,0.21,8116,2159,10275
2106607,MATÕES,MA,0.872,0.128,14552,2144,16696
2111763,SENADOR LA ROCQUE,MA,0.745,0.255,6100,2093,8193
2106003,LIMA CAMPOS,MA,0.7,0.3,4796,2060,6856
2100436,ALTO ALEGRE DO MARANHÃO,MA,0.834,0.166,10064,2010,12074
2108702,PIO XII,MA,0.85,0.15,11317,2003,13320
2105005,HUMBERTO DE CAMPOS,MA,0.843,0.157,10553,1958,12511
2102556,CAMPESTRE DO MARANHÃO,MA,0.699,0.301,4543,1957,6500
2102606,CÂNDIDO MENDES,MA,0.795,0.205,7542,1942,9484
2112100,TIMBIRAS,MA,0.855,0.145,11438,1936,13374
2100303,ALDEIAS ALTAS,MA,0.837,0.163,9719,1899,11618
2104107,FORTALEZA DOS NOGUEIRAS,MA,0.728,0.272,5029,1879,6908
2106904,MONÇÃO,MA,0.864,0.136,11864,1875,13739
2111532,SÃO PEDRO DA ÁGUA BRANCA,MA,0.685,0.315,4047,1857,5904
2105203,IGARAPÉ GRANDE,MA,0.685,0.315,4024,1853,5877
2112605,URBANO SANTOS,MA,0.887,0.113,14355,1835,16190
2104008,ESPERANTINÓPOLIS,MA,0.819,0.181,8042,1781,9823
2110856,SÃO FRANCISCO DO BREJÃO,MA,0.635,0.365,3085,1776,4861
2100477,ALTO ALEGRE DO PINDARÉ,MA,0.869,0.131,11513,1741,13254
2103257,CIDELÂNDIA,MA,0.765,0.235,5674,1739,7413
2111052,SÃO JOÃO DO PARAÍSO,MA,0.703,0.297,4058,1717,5775
2106300,MAGALHÃES DE ALMEIDA,MA,0.787,0.213,6261,1697,7958
2100709,ANAJATUBA,MA,0.865,0.135,10794,1690,12484
2107803,PARNARAMA,MA,0.899,0.101,14918,1676,16594
2107902,PASSAGEM FRANCA,MA,0.821,0.179,7677,1672,9349
2110104,SANTA QUITÉRIA DO MARANHÃO,MA,0.88,0.12,12201,1668,13869
2106409,MATA ROMA,MA,0.841,0.159,8737,1652,10389
2112852,VILA NOVA DOS MARTÍRIOS,MA,0.66,0.34,3205,1650,4855
2100832,APICUM-AÇU,MA,0.785,0.215,6014,1649,7663
2108306,PENALVA,MA,0.894,0.106,13696,1628,15324
2104404,GONÇALVES DIAS,MA,0.811,0.189,6930,1619,8549
2101251,BACABEIRA,MA,0.843,0.157,8712,1618,10330
2111573,SÃO PEDRO DOS CRENTES,MA,0.425,0.575,1191,1611,2802
2102200,BURITI,MA,0.886,0.114,12504,1608,14112
2107407,OLHO D'ÁGUA DAS CUNHÃS,MA,0.833,0.167,8004,1606,9610
2107100,MORROS,MA,0.84,0.16,8239,1575,9814
2105104,ICATU,MA,0.877,0.123,11097,1551,12648
2101905,BEQUIMÃO,MA,0.856,0.144,9026,1519,10545
2106706,MIRADOR,MA,0.854,0.146,8886,1514,10400
2108009,PASTOS BONS,MA,0.841,0.159,7930,1504,9434
2100204,ALCÂNTARA,MA,0.859,0.141,9125,1504,10629
2102309,BURITI BRAVO,MA,0.875,0.125,10332,1470,11802
2109551,RIBAMAR FIQUENE,MA,0.668,0.332,2942,1459,4401
2108454,PERITORÓ,MA,0.869,0.131,9674,1457,11131
2100501,ALTO PARNAÍBA,MA,0.72,0.28,3744,1453,5197
2103554,CONCEIÇÃO DO LAGO-AÇU,MA,0.804,0.196,5890,1436,7326
2100808,ANAPURUS,MA,0.853,0.147,8094,1394,9488
2105989,LAJEADO NOVO,MA,0.674,0.326,2872,1386,4258
2105609,JOSELÂNDIA,MA,0.817,0.183,6176,1382,7558
2107704,PARAIBANO,MA,0.858,0.142,8298,1372,9670
2106805,MIRINZAL,MA,0.808,0.192,5740,1360,7100
2111409,SÃO LUÍS GONZAGA DO MARANHÃO,MA,0.89,0.11,10954,1359,12313
2107357,NOVA OLINDA DO MARANHÃO,MA,0.839,0.161,7010,1341,8351
2112001,TASSO FRAGOSO,MA,0.696,0.304,3045,1333,4378
2105476,JENIPAPO DOS VIEIRAS,MA,0.841,0.159,6844,1291,8135
2102754,CAPINZAL DO NORTE,MA,0.792,0.208,4850,1276,6126
2104206,FORTUNA,MA,0.847,0.153,6981,1263,8244
2105807,LAGO DO JUNCO,MA,0.795,0.205,4898,1262,6160
2112456,TURILÂNDIA,MA,0.858,0.142,7558,1252,8810
2104602,GOVERNADOR EUGÊNIO BARROS,MA,0.837,0.163,6396,1250,7646
2107001,MONTES ALTOS,MA,0.745,0.255,3634,1243,4877
2105948,LAGO DOS RODRIGUES,MA,0.791,0.209,4598,1217,5815
2104073,FEIRA NOVA DO MARANHÃO,MA,0.717,0.283,3083,1216,4299
2104305,GODOFREDO VIANA,MA,0.736,0.264,3340,1195,4535
2102705,CANTANHEDE,MA,0.861,0.139,7311,1179,8490
2105351,ITAIPAVA DO GRAJAÚ,MA,0.817,0.183,5254,1178,6432
2103174,CENTRO NOVO DO MARANHÃO,MA,0.85,0.15,6495,1150,7645
2108256,PEDRO DO ROSÁRIO,MA,0.894,0.106,9700,1146,10846
2105963,LAGOA GRANDE DO MARANHÃO,MA,0.82,0.18,5200,1141,6341
2108801,PIRAPEMAS,MA,0.864,0.136,7233,1136,8369
2102077,BOM LUGAR,MA,0.83,0.17,5541,1131,6672
2106201,LUÍS DOMINGUES,MA,0.683,0.317,2407,1116,3523
2110401,SÃO BENEDITO DO RIO PRETO,MA,0.89,0.11,9034,1116,10150
2111706,SÃO VICENTE FERRER,MA,0.883,0.117,8352,1111,9463
2101509,BARÃO DE GRAJAÚ,MA,0.891,0.109,9080,1110,10190
2111029,SÃO JOÃO DO CARÚ,MA,0.825,0.175,5198,1101,6299
2101103,AXIXÁ,MA,0.839,0.161,5448,1049,6497
2111003,SÃO JOÃO BATISTA,MA,0.909,0.091,10398,1036,11434
2100154,ÁGUA DOCE DO MARANHÃO,MA,0.859,0.141,6279,1027,7306
2101772,BELA VISTA DO MARANHÃO,MA,0.837,0.163,5266,1026,6292
2108058,PAULINO NEVES,MA,0.884,0.116,7811,1025,8836
2111904,SUCUPIRA DO NORTE,MA,0.824,0.176,4801,1024,5825
2106102,LORETO,MA,0.822,0.178,4674,1014,5688
2109270,PRESIDENTE SARNEY,MA,0.894,0.106,8456,1002,9458
2104081,FERNANDO FALCÃO,MA,0.829,0.171,4812,993,5805
2107605,PALMEIRÂNDIA,MA,0.903,0.097,9139,984,10123
2105153,IGARAPÉ DO MEIO,MA,0.875,0.125,6680,957,7637
2105906,LAGO VERDE,MA,0.883,0.117,7240,957,8197
2101301,BACURI,MA,0.887,0.113,7290,930,8220
2109700,SAMBAÍBA,MA,0.72,0.28,2392,928,3320
2104503,GOVERNADOR ARCHER,MA,0.831,0.169,4478,911,5389
2111748,SENADOR ALEXANDRE COSTA,MA,0.823,0.177,4216,908,5124
2102507,CAJARI,MA,0.909,0.091,8836,881,9717
2102150,BREJO DE AREIA,MA,0.819,0.181,3969,879,4848
2103109,CEDRAL,MA,0.829,0.171,4260,877,5137
2104628,GOVERNADOR LUIZ ROCHA,MA,0.777,0.223,3049,876,3925
2107456,OLINDA NOVA DO MARANHÃO,MA,0.861,0.139,5384,869,6253
2101939,BERNARDO DO MEARIM,MA,0.758,0.242,2645,845,3490
2106375,MARANHÃOZINHO,MA,0.841,0.159,4380,825,5205
2111078,SÃO JOÃO DO SOTER,MA,0.906,0.094,7948,822,8770
2107209,NINA RODRIGUES,MA,0.868,0.132,5104,777,5881
2104651,GOVERNADOR NEWTON BELLO,MA,0.845,0.155,4138,757,4895
2109205,PRESIDENTE JUSCELINO,MA,0.876,0.124,5297,752,6049
2109056,PORTO RICO DO MARANHÃO,MA,0.774,0.226,2554,745,3299
2108405,PERI MIRIM,MA,0.887,0.113,5827,744,6571
2111722,SATUBINHA,MA,0.809,0.191,3138,741,3879
2101970,BOA VISTA DO GURUPI,MA,0.805,0.195,3038,734,3772
2107258,NOVA COLINAS,MA,0.766,0.234,2368,723,3091
2100550,AMAPÁ DO MARANHÃO,MA,0.787,0.213,2571,697,3268
2110237,SANTANA DO MARANHÃO,MA,0.863,0.137,4383,694,5077
2104909,GUIMARÃES,MA,0.885,0.115,5285,686,5971
2110278,SANTO AMARO DO MARANHÃO,MA,0.887,0.113,5381,684,6065
2100402,ALTAMIRA DO MARANHÃO,MA,0.804,0.196,2730,664,3394
2110906,SÃO FRANCISCO DO MARANHÃO,MA,0.897,0.103,5748,662,6410
2106359,MARAJÁ DO SENA,MA,0.848,0.152,3643,654,4297
2105450,JATOBÁ,MA,0.856,0.144,3852,650,4502
2103158,CENTRO DO GUILHERME,MA,0.868,0.132,4258,650,4908
2104701,GRAÇA ARANHA,MA,0.833,0.167,3207,643,3850
2110658,SÃO DOMINGOS DO AZEITÃO,MA,0.848,0.152,3571,639,4210
2109759,SANTA FILOMENA DO MARANHÃO,MA,0.845,0.155,3287,605,3892
2109304,PRESIDENTE VARGAS,MA,0.906,0.094,5785,597,6382
2103901,DUQUE BACELAR,MA,0.909,0.091,5931,591,6522
2100873,ARAGUANÃ,MA,0.882,0.118,4315,580,4895
2105922,LAGOA DO MATO,MA,0.899,0.101,5144,576,5720
2109403,PRIMEIRA CRUZ,MA,0.904,0.096,5131,542,5673
2102374,CACHOEIRA GRANDE,MA,0.89,0.11,4284,531,4815
2112274,TUFILÂNDIA,MA,0.867,0.133,3436,528,3964
2105658,JUNCO DO MARANHÃO,MA,0.853,0.147,2997,518,3515
2111631,SÃO RAIMUNDO DO DOCA BEZERRA,MA,0.85,0.15,2935,517,3452
2106631,MATÕES DO NORTE,MA,0.89,0.11,3974,491,4465
2109239,PRESIDENTE MÉDICI,MA,0.859,0.141,2944,484,3428
2111250,SÃO JOSÉ DOS BASÍLIOS,MA,0.895,0.105,3743,439,4182
2101806,BENEDITO LEITE,MA,0.847,0.153,2439,439,2878
2102408,CAJAPIÓ,MA,0.922,0.078,4956,422,5378
2106672,MILAGRES DO MARANHÃO,MA,0.889,0.111,3340,418,3758
2111672,SÃO ROBERTO,MA,0.869,0.131,2758,417,3175
2100105,AFONSO CUNHA,MA,0.915,0.085,4048,374,4422
2110807,SÃO FÉLIX DE BALSAS,MA,0.855,0.145,2190,370,2560
2107308,NOVA IORQUE,MA,0.864,0.136,2311,364,2675
2101350,BACURITUBA,MA,0.89,0.11,2728,338,3066
2111789,SERRANO DO MARANHÃO,MA,0.936,0.064,4743,322,5065
2103125,CENTRAL DO MARANHÃO,MA,0.921,0.079,3669,313,3982
2111953,SUCUPIRA DO RIACHÃO,MA,0.895,0.105,2538,298,2836
2101731,BELÁGUA,MA,0.937,0.063,4358,295,4653
5103403,CUIABÁ,MT,0.331,0.669,109681,222077,331758
5108402,VÁRZEA GRANDE,MT,0.38,0.62,53552,87193,140745
5107602,RONDONÓPOLIS,MT,0.313,0.687,33847,74166,108013
5107909,SINOP,MT,0.226,0.774,15331,52446,67777
5107958,TANGARÁ DA SERRA,MT,0.229,0.771,10314,34821,45135
5107925,SORRISO,MT,0.245,0.755,9939,30599,40538
5107040,PRIMAVERA DO LESTE,MT,0.215,0.785,6846,24938,31784
5102504,CÁCERES,MT,0.456,0.544,19254,22961,42215
5105259,LUCAS DO RIO VERDE,MT,0.244,0.756,7406,22894,30300
5100250,ALTA FLORESTA,MT,0.298,0.702,7791,18321,26112
5101803,BARRA DO GARÇAS,MT,0.362,0.638,10350,18236,28586
5106752,PONTES E LACERDA,MT,0.228,0.772,4749,16121,20870
5106224,NOVA MUTUM,MT,0.231,0.769,4595,15291,19886
5102678,CAMPO VERDE,MT,0.273,0.727,5577,14839,20416
5105150,JUÍNA,MT,0.308,0.692,6438,14479,20917
5103205,COLÍDER,MT,0.174,0.826,2741,13051,15792
5105101,JUARA,MT,0.248,0.752,3790,11471,15261
5104104,GUARANTÃ DO NORTE,MT,0.209,0.791,2963,11228,14191
5102637,CAMPO NOVO DO PARECIS,MT,0.302,0.698,4549,10513,15062
5104807,JACIARA,MT,0.31,0.69,4434,9854,14288
5105622,MIRASSOL D'OESTE,MT,0.313,0.687,4009,8784,12793
5100201,ÁGUA BOA,MT,0.205,0.795,2258,8733,10991
5103353,CONFRESA,MT,0.338,0.662,4172,8181,12353
5101704,BARRA DO BUGRES,MT,0.487,0.513,7636,8047,15683
5103254,COLNIZA,MT,0.316,0.684,3498,7570,11068
5102702,CANARANA,MT,0.235,0.765,2286,7452,9738
5106422,PEIXOTO DE AZEVEDO,MT,0.471,0.529,6283,7067,13350
5103502,DIAMANTINO,MT,0.346,0.654,3687,6984,10671
5107875,SAPEZAL,MT,0.287,0.713,2730,6794,9524
5106307,PARANATINGA,MT,0.297,0.703,2829,6686,9515
5106257,NOVA XAVANTINA,MT,0.315,0.685,3015,6544,9559
5107107,SÃO JOSÉ DOS QUATRO MARCOS,MT,0.302,0.698,2793,6462,9255
5106505,POCONÉ,MT,0.632,0.368,10374,6051,16425
5107065,QUERÊNCIA,MT,0.247,0.753,1954,5965,7919
5103304,COMODORO,MT,0.324,0.676,2855,5947,8802
5101258,ARAPUTANGA,MT,0.27,0.73,2172,5860,8032
5107305,SÃO JOSÉ DO RIO CLARO,MT,0.252,0.748,1854,5517,7371
5105606,MATUPÁ,MT,0.296,0.704,2314,5509,7823
5107800,SANTO ANTÔNIO DO LEVERGER,MT,0.525,0.475,6012,5445,11457
5103007,CHAPADA DOS GUIMARÃES,MT,0.484,0.516,5091,5438,10529
5108600,VILA RICA,MT,0.319,0.681,2542,5429,7971
5105903,NOBRES,MT,0.336,0.664,2667,5274,7941
5101407,ARIPUANÃ,MT,0.311,0.689,2325,5148,7473
5101902,BRASNORTE,MT,0.317,0.683,2371,5097,7468
5100300,ALTO ARAGUAIA,MT,0.35,0.65,2687,5001,7688
5106372,PEDRA PRETA,MT,0.42,0.58,3602,4979,8581
5106216,NOVA CANAÃ DO NORTE,MT,0.278,0.722,1878,4883,6761
5106158,NOVA BANDEIRANTES,MT,0.242,0.758,1381,4318,5699
5108006,TAPURAH,MT,0.217,0.783,1182,4259,5441
5105580,MARCELÂNDIA,MT,0.275,0.725,1585,4181,5766
5107701,ROSÁRIO OESTE,MT,0.522,0.478,4417,4041,8458
5106299,PARANAÍTA,MT,0.319,0.681,1861,3979,5840
5106232,NOVA OLÍMPIA,MT,0.494,0.506,3862,3948,7810
5107008,POXORÉU,MT,0.511,0.489,4094,3910,8004
5103056,CLÁUDIA,MT,0.261,0.739,1360,3850,5210
5105200,JUSCIMEIRA,MT,0.388,0.612,2338,3685,6023
5105002,JAURU,MT,0.267,0.733,1342,3683,5025
5105507,VILA BELA DA SANTÍSSIMA TRINDADE,MT,0.433,0.567,2813,3677,6490
5104609,ITIQUIRA,MT,0.353,0.647,2004,3666,5670
5108055,TERRA NOVA DO NORTE,MT,0.394,0.606,2278,3498,5776
5103379,COTRIGUAÇU,MT,0.387,0.613,2114,3342,5456
5107941,TABAPORÃ,MT,0.245,0.755,1083,3331,4414
5101308,ARENÁPOLIS,MT,0.374,0.626,1908,3187,5095
5100409,ALTO GARÇAS,MT,0.352,0.648,1730,3183,4913
5104203,GUIRATINGA,MT,0.428,0.572,2365,3162,5527
5100607,ALTO TAQUARI,MT,0.276,0.724,1197,3139,4336
5108501,VERA,MT,0.291,0.709,1238,3014,4252
5106240,NOVA UBIRATÃ,MT,0.31,0.69,1267,2824,4091
5107180,RIBEIRÃO CASCALHEIRA,MT,0.346,0.654,1445,2735,4180
5106828,PORTO ESPERIDIÃO,MT,0.46,0.54,2319,2722,5041
5106109,NOSSA SENHORA DO LIVRAMENTO,MT,0.661,0.339,5290,2719,8009
5106778,PORTO ALEGRE DO NORTE,MT,0.397,0.603,1788,2719,4507
5102793,CARLINDA,MT,0.467,0.533,2350,2685,5035
5108956,NOVA MONTE VERDE,MT,0.301,0.699,1141,2644,3785
5103601,DOM AQUINO,MT,0.391,0.609,1660,2586,4246
5105176,JURUENA,MT,0.342,0.658,1327,2555,3882
5103700,FELIZ NATAL,MT,0.368,0.632,1475,2536,4011
5102603,CAMPINÁPOLIS,MT,0.597,0.403,3739,2528,6267
5107859,SÃO FÉLIX DO ARAGUAIA,MT,0.385,0.615,1571,2514,4085
5102850,CASTANHEIRA,MT,0.391,0.609,1520,2366,3886
5104542,ITANHANGÁ,MT,0.203,0.797,601,2364,2965
5104526,IPIRANGA DO NORTE,MT,0.223,0.777,641,2230,2871
5106265,NOVO MUNDO,MT,0.341,0.659,1153,2229,3382
5102686,CAMPOS DE JÚLIO,MT,0.264,0.736,792,2210,3002
5103858,GAÚCHA DO NORTE,MT,0.335,0.665,1094,2173,3267
5103452,DENISE,MT,0.434,0.566,1641,2144,3785
5106653,PONTAL DO ARAGUAIA,MT,0.389,0.611,1350,2116,3466
5106281,NOVO SÃO JOAQUIM,MT,0.33,0.67,1028,2085,3113
5100805,APIACÁS,MT,0.397,0.603,1366,2071,3437
5100102,ACORIZAL,MT,0.566,0.434,2526,1937,4463
5107248,SANTA CARMEM,MT,0.233,0.767,573,1886,2459
5104906,JANGADA,MT,0.605,0.395,2830,1849,4679
5106802,PORTO DOS GAÚCHOS,MT,0.306,0.694,813,1843,2656
5108907,NOVA MARINGÁ,MT,0.29,0.71,726,1780,2506
5106000,NORTELÂNDIA,MT,0.461,0.539,1516,1770,3286
5103437,CURVELÂNDIA,MT,0.359,0.641,985,1755,2740
5100359,ALTO BOA VISTA,MT,0.248,0.752,572,1735,2307
5104559,ITAÚBA,MT,0.336,0.664,871,1724,2595
5100508,ALTO PARAGUAI,MT,0.585,0.415,2412,1714,4126
5106182,NOVA LACERDA,MT,0.393,0.607,1081,1667,2748
5107206,RIO BRANCO,MT,0.398,0.602,1084,1639,2723
5103809,FIGUEIRÓPOLIS D'OESTE,MT,0.218,0.782,441,1581,2022
5102694,CANABRAVA DO NORTE,MT,0.34,0.66,814,1580,2394
5108808,NOVA GUARITA,MT,0.399,0.601,1043,1571,2614
5105234,LAMBARI D'OESTE,MT,0.469,0.531,1356,1535,2891
5101852,BOM JESUS DO ARAGUAIA,MT,0.464,0.536,1321,1523,2844
5106273,NOVO HORIZONTE DO NORTE,MT,0.345,0.655,747,1420,2167
5107750,SALTO DO CÉU,MT,0.334,0.666,705,1404,2109
5108352,VALE DE SÃO DOMINGOS,MT,0.245,0.755,445,1369,1814
5103106,COCALINHO,MT,0.468,0.532,1174,1333,2507
5107354,SÃO JOSÉ DO XINGU,MT,0.488,0.512,1250,1314,2564
5106190,NOVA SANTA HELENA,MT,0.313,0.687,595,1307,1902
5103361,CONQUISTA D'OESTE,MT,0.293,0.707,541,1307,1848
5107404,SÃO PEDRO DA CIPA,MT,0.476,0.524,1144,1260,2404
5101605,BARÃO DE MELGAÇO,MT,0.681,0.319,2618,1225,3843
5108204,TORIXORÉU,MT,0.46,0.54,1021,1200,2221
5103957,GLÓRIA D'OESTE,MT,0.35,0.65,624,1159,1783
5107776,SANTA TEREZINHA,MT,0.609,0.391,1790,1151,2941
5108857,NOVA MARILÂNDIA,MT,0.346,0.654,575,1088,1663
5106208,NOVA BRASILÂNDIA,MT,0.539,0.461,1266,1082,2348
5107297,SÃO JOSÉ DO POVO,MT,0.451,0.549,876,1065,1941
5108303,UNIÃO DO SUL,MT,0.393,0.607,670,1036,1706
5101001,ARAGUAIANA,MT,0.46,0.54,859,1008,1867
5106455,PLANALTO DA SERRA,MT,0.509,0.491,1025,989,2014
5107792,SANTO ANTÔNIO DO LESTE,MT,0.336,0.664,493,973,1466
5103908,GENERAL CARNEIRO,MT,0.633,0.367,1656,959,2615
5107768,SANTA RITA DO TRIVELATO,MT,0.309,0.691,376,840,1216
5104500,INDIAVAÍ,MT,0.38,0.62,505,824,1329
5107263,SANTO AFONSO,MT,0.457,0.543,673,800,1473
5105309,LUCIARA,MT,0.441,0.559,587,745,1332
5107156,RESERVA DO CABAÇAL,MT,0.415,0.585,521,735,1256
5106174,NOVA NAZARÉ,MT,0.513,0.487,757,720,1477
5106851,PORTO ESTRELA,MT,0.676,0.324,1456,698,2154
5108105,TESOURO,MT,0.506,0.494,706,690,1396
5107198,RIBEIRÃOZINHO,MT,0.488,0.512,650,683,1333
5107578,RONDOLÂNDIA,MT,0.548,0.452,824,680,1504
5107743,SANTA CRUZ DO XINGU,MT,0.298,0.702,286,674,960
5107883,SERRA NOVA DOURADA,MT,0.365,0.635,316,549,865
5106315,NOVO SANTO ANTÔNIO,MT,0.491,0.509,496,514,1010
5106703,PONTE BRANCA,MT,0.629,0.371,763,451,1214
5101209,ARAGUAINHA,MT,0.474,0.526,296,329,625
5002704,CAMPO GRANDE,MS,0.287,0.713,135939,337170,473109
5003702,DOURADOS,MS,0.318,0.682,35815,76753,112568
5008305,TRÊS LAGOAS,MS,0.326,0.674,16944,34967,51911
5006606,PONTA PORÃ,MS,0.32,0.68,13906,29496,43402
5003207,CORUMBÁ,MS,0.425,0.575,20013,27107,47120
5005707,NAVIRAÍ,MS,0.308,0.692,7332,16460,23792
5006200,NOVA ANDRADINA,MS,0.372,0.628,8304,14015,22319
5005400,MARACAJU,MS,0.324,0.676,6414,13404,19818
5006309,PARANAÍBA,MS,0.366,0.634,7376,12781,20157
5001102,AQUIDAUANA,MS,0.44,0.56,9719,12369,22088
5007901,SIDROLÂNDIA,MS,0.433,0.567,9242,12110,21352
5007208,RIO BRILHANTE,MS,0.4,0.6,7047,10583,17630
5007695,SÃO GABRIEL DO OESTE,MS,0.27,0.73,3691,9997,13688
5000609,AMAMBAI,MS,0.426,0.574,7354,9916,17270
5003306,COXIM,MS,0.397,0.603,6376,9704,16080
5002407,CAARAPÓ,MS,0.351,0.649,4961,9178,14139
5002951,CHAPADÃO DO SUL,MS,0.247,0.753,2917,8869,11786
5004700,IVINHEMA,MS,0.353,0.647,4756,8712,13468
5003256,COSTA RICA,MS,0.364,0.636,4710,8245,12955
5001003,APARECIDA DO TABOADO,MS,0.299,0.701,3420,8005,11425
5005004,JARDIM,MS,0.336,0.664,3973,7847,11820
5002902,CASSILÂNDIA,MS,0.287,0.713,2869,7125,9994
5002209,BONITO,MS,0.388,0.612,4507,7096,11603
5003801,FÁTIMA DO SUL,MS,0.386,0.614,4458,7087,11545
5001904,BATAGUASSU,MS,0.37,0.63,4145,7059,11204
5000708,ANASTÁCIO,MS,0.412,0.588,4920,7024,11944
5004502,ITAPORÃ,MS,0.318,0.682,3025,6496,9521
5005681,MUNDO NOVO,MS,0.345,0.655,3291,6248,9539
5002100,BELA VISTA,MS,0.415,0.585,4394,6188,10582
5007406,RIO VERDE DE MATO GROSSO,MS,0.382,0.618,3514,5675,9189
5005608,MIRANDA,MS,0.559,0.441,7117,5626,12743
5006002,NOVA ALVORADA DO SUL,MS,0.434,0.566,4105,5360,9465
5007109,RIBAS DO RIO PARDO,MS,0.405,0.595,3588,5264,8852
5005202,LADÁRIO,MS,0.424,0.576,3732,5073,8805
5008008,TERENOS,MS,0.441,0.559,3956,5007,8963
5002605,CAMAPUÃ,MS,0.397,0.603,2943,4462,7405
5007935,SONORA,MS,0.41,0.59,2989,4293,7282
5000203,ÁGUA CLARA,MS,0.369,0.631,2501,4269,6770
5004304,IGUATEMI,MS,0.356,0.644,2346,4247,6593
5004601,ITAQUIRAÍ,MS,0.508,0.492,4327,4183,8510
5003454,DEODÁPOLIS,MS,0.408,0.592,2750,3983,6733
5003751,ELDORADO,MS,0.327,0.673,1830,3771,5601
5002308,BRASILÂNDIA,MS,0.348,0.652,1981,3719,5700
5005806,NIOAQUE,MS,0.481,0.519,3332,3597,6929
5003157,CORONEL SAPUCAIA,MS,0.487,0.513,3351,3532,6883
5007703,SETE QUEDAS,MS,0.354,0.646,1728,3149,4877
5002001,BATAYPORÃ,MS,0.443,0.557,2445,3073,5518
5004007,GLÓRIA DE DOURADOS,MS,0.416,0.584,2186,3072,5258
5000856,ANGÉLICA,MS,0.46,0.54,2585,3038,5623
5004106,GUIA LOPES DA LAGUNA,MS,0.396,0.604,1914,2916,4830
5006903,PORTO MURTINHO,MS,0.418,0.582,1957,2727,4684
5000906,ANTÔNIO JOÃO,MS,0.441,0.559,2060,2607,4667
5001243,ARAL MOREIRA,MS,0.467,0.533,2228,2547,4775
5004403,INOCÊNCIA,MS,0.329,0.671,1209,2467,3676
5006358,PARANHOS,MS,0.532,0.468,2741,2411,5152
5002159,BODOQUENA,MS,0.447,0.553,1886,2332,4218
5001508,BANDEIRANTES,MS,0.444,0.556,1813,2269,4082
5005251,LAGUNA CARAPÃ,MS,0.387,0.613,1342,2129,3471
5000807,ANAURILÂNDIA,MS,0.475,0.525,1849,2046,3895
5003488,DOIS IRMÃOS DO BURITI,MS,0.621,0.379,3330,2029,5359
5006408,PEDRO GOMES,MS,0.472,0.528,1807,2018,3825
5004908,JARAGUARI,MS,0.42,0.58,1379,1907,3286
5008404,VICENTINA,MS,0.532,0.468,2134,1881,4015
5003504,DOURADINA,MS,0.418,0.582,1346,1876,3222
5007505,ROCHEDO,MS,0.341,0.659,922,1785,2707
5002803,CARACOL,MS,0.402,0.598,1191,1770,2961
5006275,PARAÍSO DAS ÁGUAS,MS,0.247,0.753,567,1731,2298
5007802,SELVÍRIA,MS,0.559,0.441,2152,1697,3849
5007554,SANTA RITA DO PARDO,MS,0.417,0.583,1203,1682,2885
5005152,JUTI,MS,0.536,0.464,1864,1612,3476
5007307,RIO NEGRO,MS,0.417,0.583,1063,1487,2550
5007950,TACURU,MS,0.672,0.328,2954,1443,4397
5003108,CORGUINHO,MS,0.429,0.571,1025,1364,2389
5005103,JATEÍ,MS,0.476,0.524,1204,1324,2528
5006259,NOVO HORIZONTE DO SUL,MS,0.488,0.512,1253,1312,2565
5000252,ALCINÓPOLIS,MS,0.47,0.53,1059,1194,2253
5004809,JAPORÃ,MS,0.684,0.316,2559,1184,3743
5007976,TAQUARUSSU,MS,0.55,0.45,1220,998,2218
5003900,FIGUEIRÃO,MS,0.427,0.573,670,900,1570
3106200,BELO HORIZONTE,MG,0.344,0.656,472887,901513,1374400
3170206,UBERLÂNDIA,MG,0.37,0.63,128070,218367,346437
3118601,CONTAGEM,MG,0.342,0.658,105418,202384,307802
3136702,JUIZ DE FORA,MG,0.476,0.524,132237,145333,277570
3106705,BETIM,MG,0.38,0.62,75026,122576,197602
3143302,MONTES CLAROS,MG,0.418,0.582,78142,108640,186782
3170107,UBERABA,MG,0.344,0.656,55842,106569,162411
3127701,GOVERNADOR VALADARES,MG,0.289,0.711,38293,94067,132360
3131307,IPATINGA,MG,0.259,0.741,32082,91851,123933
3154606,RIBEIRÃO DAS NEVES,MG,0.404,0.596,55911,82449,138360
3167202,SETE LAGOAS,MG,0.303,0.697,34449,79126,113575
3122306,DIVINÓPOLIS,MG,0.348,0.652,41154,77001,118155
3157807,SANTA LUZIA,MG,0.376,0.624,41289,68452,109741
3151800,POÇOS DE CALDAS,MG,0.305,0.695,23578,53695,77273
3148004,PATOS DE MINAS,MG,0.279,0.721,20583,53299,73882
3152501,POUSO ALEGRE,MG,0.278,0.722,19916,51716,71632
3170701,VARGINHA,MG,0.268,0.732,18711,51221,69932
3129806,IBIRITÉ,MG,0.405,0.595,32827,48160,80987
3103504,ARAGUARI,MG,0.314,0.686,19055,41697,60752
3132404,ITAJUBÁ,MG,0.223,0.777,11330,39418,50748
3156700,SABARÁ,MG,0.384,0.616,24351,39086,63437
3133808,ITAÚNA,MG,0.228,0.772,10993,37146,48139
3105608,BARBACENA,MG,0.477,0.523,32411,35585,67996
3119401,CORONEL FABRICIANO,MG,0.339,0.661,18177,35471,53648
3131703,ITABIRA,MG,0.418,0.582,25229,35136,60365
3118304,CONSELHEIRO LAFAIETE,MG,0.463,0.537,30180,35020,65200
3171204,VESPASIANO,MG,0.388,0.612,21739,34281,56020
3168606,TEÓFILO OTONI,MG,0.454,0.546,28194,33970,62164
3147907,PASSOS,MG,0.371,0.629,19919,33806,53725
3104007,ARAXÁ,MG,0.364,0.636,18890,33021,51911
3147105,PARÁ DE MINAS,MG,0.25,0.75,10834,32428,43262
3138203,LAVRAS,MG,0.359,0.641,17435,31119,48554
3143906,MURIAÉ,MG,0.407,0.593,21306,31027,52333
3145208,NOVA SERRANA,MG,0.209,0.791,8174,30914,39088
3148103,PATROCÍNIO,MG,0.295,0.705,12725,30375,43100
3144805,NOVA LIMA,MG,0.393,0.607,19264,29780,49044
3162500,SÃO JOÃO DEL REI,MG,0.37,0.63,17250,29334,46584
3169901,UBÁ,MG,0.411,0.589,19993,28658,48651
3168705,TIMÓTEO,MG,0.307,0.693,12599,28465,41064
3101607,ALFENAS,MG,0.317,0.683,12837,27671,40508
3170404,UNAÍ,MG,0.326,0.674,13392,27649,41041
3169307,TRÊS CORAÇÕES,MG,0.283,0.717,10716,27186,37902
3147006,PARACATU,MG,0.347,0.653,14125,26622,40747
3134202,ITUIUTABA,MG,0.496,0.504,25456,25815,51271
3126109,FORMIGA,MG,0.293,0.707,10499,25314,35813
3113404,CARATINGA,MG,0.379,0.621,14556,23811,38367
3139409,MANHUAÇU,MG,0.392,0.608,15267,23678,38945
3136207,JOÃO MONLEVADE,MG,0.397,0.603,15451,23443,38894
3137601,LAGOA SANTA,MG,0.29,0.71,9088,22301,31389
3149309,PEDRO LEOPOLDO,MG,0.349,0.651,11414,21303,32717
3120904,CURVELO,MG,0.458,0.542,17396,20575,37971
3164704,SÃO SEBASTIÃO DO PARAÍSO,MG,0.35,0.65,10986,20394,31380
3107406,BOM DESPACHO,MG,0.251,0.749,6441,19194,25635
3111200,CAMPO BELO,MG,0.306,0.694,7805,17661,25466
3124104,ESMERALDAS,MG,0.45,0.55,14139,17287,31426
3127107,FRUTAL,MG,0.363,0.637,9794,17194,26988
3169406,TRÊS PONTAS,MG,0.433,0.567,13133,17169,30302
3137205,LAGOA DA PRATA,MG,0.28,0.72,6642,17088,23730
3163706,SÃO LOURENÇO,MG,0.247,0.753,5561,16961,22522
3159605,SANTA RITA DO SAPUCAÍ,MG,0.197,0.803,4134,16799,20933
3118007,CONGONHAS,MG,0.411,0.589,11565,16554,28119
3131901,ITABIRITO,MG,0.402,0.598,10996,16365,27361
3115300,CATAGUASES,MG,0.55,0.45,19908,16256,36164
3102605,ANDRADAS,MG,0.222,0.778,4563,15971,20534
3151206,PIRAPORA,MG,0.384,0.616,9897,15910,25807
3171303,VIÇOSA,MG,0.59,0.41,22851,15900,38751
3128709,GUAXUPÉ,MG,0.404,0.596,10366,15289,25655
3139003,MACHADO,MG,0.267,0.733,5408,14841,20249
3135100,JANAÚBA,MG,0.549,0.451,17863,14684,32547
3146107,OURO PRETO,MG,0.646,0.354,26726,14664,41390
3125101,EXTREMA,MG,0.296,0.704,5878,13952,19830
3145604,OLIVEIRA,MG,0.363,0.637,7888,13844,21732
3110004,CAETÉ,MG,0.386,0.614,8544,13593,22137
3104205,ARCOS,MG,0.363,0.637,7726,13571,21297
3146008,OURO FINO,MG,0.218,0.782,3647,13102,16749
3107109,BOA ESPERANÇA,MG,0.368,0.632,7496,12864,20360
3138401,LEOPOLDINA,MG,0.528,0.472,14278,12774,27052
3136306,JOÃO PINHEIRO,MG,0.444,0.556,10078,12632,22710
3143104,MONTE CARMELO,MG,0.469,0.531,11117,12586,23703
3109006,BRUMADINHO,MG,0.37,0.63,7164,12215,19379
3145901,OURO BRANCO,MG,0.419,0.581,8795,12198,20993
3160702,SANTOS DUMONT,MG,0.541,0.459,14206,12068,26274
3141108,MATOZINHOS,MG,0.391,0.609,7658,11934,19592
3140001,MARIANA,MG,0.626,0.374,19882,11883,31765
3130101,IGARAPÉ,MG,0.394,0.606,7712,11868,19580
3162104,SÃO GOTARDO,MG,0.299,0.701,4978,11663,16641
3152105,PONTE NOVA,MG,0.605,0.395,17795,11604,29399
3151503,PIUMHI,MG,0.305,0.695,5092,11579,16671
3172004,VISCONDE DO RIO BRANCO,MG,0.455,0.545,9396,11264,20660
3151404,PITANGUI,MG,0.264,0.736,3859,10743,14602
3114303,CARMO DO PARANAÍBA,MG,0.259,0.741,3686,10525,14211
3160405,SANTO ANTÔNIO DO MONTE,MG,0.209,0.791,2749,10425,13174
3168002,TAIOBEIRAS,MG,0.347,0.653,5537,10419,15956
3123601,ELÓI MENDES,MG,0.262,0.738,3689,10394,14083
3143401,MONTE SIÃO,MG,0.172,0.828,2155,10372,12527
3116605,CLÁUDIO,MG,0.255,0.745,3546,10366,13912
3140704,MATEUS LEME,MG,0.347,0.653,5499,10341,15840
3134905,JACUTINGA,MG,0.182,0.818,2291,10264,12555
3119302,COROMANDEL,MG,0.34,0.66,5264,10220,15484
3165537,SARZEDO,MG,0.348,0.652,5246,9815,15061
3110608,CAMBUÍ,MG,0.299,0.701,4163,9755,13918
3134400,ITURAMA,MG,0.516,0.484,10313,9675,19988
3158953,SANTANA DO PARAÍSO,MG,0.311,0.689,4340,9626,13966
3101508,ALÉM PARAÍBA,MG,0.495,0.505,9318,9512,18830
3144300,NANUQUE,MG,0.47,0.53,8216,9270,17486
3169356,TRÊS MARIAS,MG,0.395,0.605,5797,8862,14659
3136652,JUATUBA,MG,0.379,0.621,5311,8705,14016
3170800,VÁRZEA DA PALMA,MG,0.449,0.551,7023,8610,15633
3121605,DIAMANTINA,MG,0.619,0.381,13966,8605,22571
3156908,SACRAMENTO,MG,0.344,0.656,4448,8501,12949
3139607,MANTENA,MG,0.359,0.641,4689,8368,13057
3105400,BARÃO DE COCAIS,MG,0.457,0.543,7043,8352,15395
3157005,SALINAS,MG,0.583,0.417,11614,8308,19922
3144607,NEPOMUCENO,MG,0.363,0.637,4738,8297,13035
3162955,SÃO JOSÉ DA LAPA,MG,0.368,0.632,4735,8141,12876
3111002,CAMPESTRE,MG,0.28,0.72,3168,8136,11304
3113305,CARANGOLA,MG,0.474,0.526,7320,8118,15438
3147402,PARAOPEBA,MG,0.372,0.628,4803,8101,12904
3147303,PARAISÓPOLIS,MG,0.269,0.731,2970,8086,11056
3162005,SÃO GONÇALO DO SAPUCAÍ,MG,0.349,0.651,4310,8057,12367
3111606,CAMPOS GERAIS,MG,0.381,0.619,4940,8022,12962
3110509,CAMANDUCAIA,MG,0.302,0.698,3403,7870,11273
3137809,LAMBARI,MG,0.29,0.71,3206,7841,11047
3162906,SÃO JOÃO NEPOMUCENO,MG,0.424,0.576,5767,7825,13592
3107307,BOCAIÚVA,MG,0.667,0.333,15564,7772,23336
3114204,CARMO DO CAJURU,MG,0.382,0.618,4794,7762,12556
3101102,AIMORÉS,MG,0.379,0.621,4715,7712,12427
3152006,POMPÉU,MG,0.479,0.521,7049,7677,14726
3128006,GUANHÃES,MG,0.456,0.544,6432,7667,14099
3144003,MUTUM,MG,0.443,0.557,6090,7666,13756
3130903,INHAPIM,MG,0.383,0.617,4753,7653,12406
3100203,ABAETÉ,MG,0.361,0.639,4289,7581,11870
3104908,BAEPENDI,MG,0.291,0.709,3106,7578,10684
3144102,MUZAMBINHO,MG,0.376,0.624,4535,7513,12048
3112307,CAPELINHA,MG,0.545,0.455,8898,7417,16315
3152204,PORTEIRINHA,MG,0.624,0.376,12196,7358,19554
3147204,PARAGUAÇU,MG,0.367,0.633,4230,7309,11539
3149903,PERDÕES,MG,0.357,0.643,4059,7300,11359
3135209,JANUÁRIA,MG,0.752,0.248,22111,7287,29398
3157203,SANTA BÁRBARA,MG,0.538,0.462,8460,7270,15730
3152808,PRATA,MG,0.471,0.529,6408,7194,13602
3113206,CARANDAÍ,MG,0.471,0.529,6402,7191,13593
3114402,CARMO DO RIO CLARO,MG,0.361,0.639,3836,6785,10621
3117306,CONCEIÇÃO DAS ALAGOAS,MG,0.486,0.514,6406,6766,13172
3143203,MONTE SANTO DE MINAS,MG,0.355,0.645,3721,6756,10477
3161106,SÃO FRANCISCO,MG,0.712,0.288,16543,6705,23248
3106309,BELO ORIENTE,MG,0.437,0.563,5200,6702,11902
3162922,SÃO JOAQUIM DE BICAS,MG,0.474,0.526,6033,6701,12734
3108305,BORDA DA MATA,MG,0.269,0.731,2440,6615,9055
3133501,ITAPECERICA,MG,0.434,0.566,5026,6562,11588
3115508,CAXAMBU,MG,0.42,0.58,4751,6550,11301
3109303,BURITIS,MG,0.439,0.561,5110,6521,11631
3118403,CONSELHEIRO PENA,MG,0.39,0.61,4111,6420,10531
3138807,LUZ,MG,0.304,0.696,2786,6385,9171
3169604,TUPACIGUARA,MG,0.523,0.477,6891,6281,13172
3139904,MARIA DA FÉ,MG,0.274,0.726,2367,6279,8646
3103405,ARAÇUAÍ,MG,0.6,0.4,9420,6278,15698
3101904,ALPINÓPOLIS,MG,0.411,0.589,4332,6205,10537
3129509,IBIÁ,MG,0.428,0.572,4572,6110,10682
3137502,LAGOA FORMOSA,MG,0.37,0.63,3590,6109,9699
3105103,BAMBUÍ,MG,0.501,0.499,6120,6090,12210
3132503,ITAMARANDIBA,MG,0.585,0.415,8541,6067,14608
3110905,CAMPANHA,MG,0.232,0.768,1824,6041,7865
3139508,MANHUMIRIM,MG,0.442,0.558,4773,6019,10792
3153400,PRESIDENTE OLEGÁRIO,MG,0.405,0.595,4090,6013,10103
3171006,VAZANTE,MG,0.423,0.577,4334,5921,10255
3154309,RESPLENDOR,MG,0.304,0.696,2569,5887,8456
3108909,BRAZÓPOLIS,MG,0.301,0.699,2508,5836,8344
3145109,NOVA RESENDE,MG,0.331,0.669,2863,5797,8660
3111101,CAMPINA VERDE,MG,0.429,0.571,4312,5744,10056
3151701,POÇO FUNDO,MG,0.367,0.633,3294,5677,8971
3133006,ITAMONTE,MG,0.28,0.72,2173,5594,7767
3104304,AREADO,MG,0.285,0.715,2224,5579,7803
3105905,BARROSO,MG,0.498,0.502,5530,5575,11105
3108008,BOM SUCESSO,MG,0.413,0.587,3899,5548,9447
3119104,CORINTO,MG,0.522,0.478,6044,5534,11578
3133758,ITAÚ DE MINAS,MG,0.327,0.673,2663,5488,8151
3135050,JAÍBA,MG,0.637,0.363,9618,5479,15097
3124302,ESPINOSA,MG,0.644,0.356,9863,5454,15317
3124203,ESPERA FELIZ,MG,0.522,0.478,5949,5453,11402
3133105,ITANHANDU,MG,0.348,0.652,2901,5428,8329
3101706,ALMENARA,MG,0.701,0.299,12687,5418,18105
3137700,LAJINHA,MG,0.475,0.525,4885,5410,10295
3147600,PASSA QUATRO,MG,0.4,0.6,3575,5360,8935
3134608,JABOTICATUBAS,MG,0.435,0.565,4092,5306,9398
3154002,RAUL SOARES,MG,0.534,0.466,6034,5272,11306
3131208,IPANEMA,MG,0.433,0.567,4023,5267,9290
3114501,CARMÓPOLIS DE MINAS,MG,0.415,0.585,3724,5254,8978
3149804,PERDIZES,MG,0.339,0.661,2695,5244,7939
3115102,CÁSSIA,MG,0.411,0.589,3640,5214,8854
3131158,IPABA,MG,0.425,0.575,3825,5175,9000
3110301,CALDAS,MG,0.316,0.684,2390,5172,7562
3169000,TOCANTINS,MG,0.431,0.569,3861,5092,8953
3102001,ALTEROSA,MG,0.392,0.608,3275,5079,8354
3142809,MONTE ALEGRE DE MINAS,MG,0.472,0.528,4500,5042,9542
3108602,BRASÍLIA DE MINAS,MG,0.688,0.312,10990,4982,15972
3162708,SÃO JOÃO DO PARAÍSO,MG,0.466,0.534,4319,4955,9274
3123205,DORES DO INDAIÁ,MG,0.304,0.696,2154,4926,7080
3128303,GUARANÉSIA,MG,0.509,0.491,5099,4914,10013
3159803,SANTA VITÓRIA,MG,0.574,0.426,6615,4908,11523
3109709,CACHOEIRA DE MINAS,MG,0.254,0.746,1654,4859,6513
3140159,MÁRIO CAMPOS,MG,0.363,0.637,2747,4822,7569
3153905,RAPOSOS,MG,0.486,0.514,4461,4723,9184
3149705,PERDIGÃO,MG,0.166,0.834,939,4715,5654
3109402,BURITIZEIRO,MG,0.58,0.42,6497,4703,11200
3140506,MARTINHO CAMPOS,MG,0.332,0.668,2326,4689,7015
3117900,CONGONHAL,MG,0.264,0.736,1668,4653,6321
3117801,CONCEIÇÃO DOS OUROS,MG,0.251,0.749,1550,4635,6185
3144706,NOVA ERA,MG,0.524,0.476,5057,4601,9658
3133709,ITATIAIUÇU,MG,0.282,0.718,1805,4599,6404
3167608,SIMONÉSIA,MG,0.508,0.492,4740,4597,9337
3128105,GUAPÉ,MG,0.338,0.662,2348,4590,6938
3155801,RIO POMBA,MG,0.517,0.483,4899,4583,9482
3120805,CRUZÍLIA,MG,0.444,0.556,3663,4583,8246
3112000,CANDEIAS,MG,0.397,0.603,3013,4576,7589
3140902,MATIPÓ,MG,0.541,0.459,5295,4496,9791
3133303,ITAOBIM,MG,0.528,0.472,5010,4485,9495
3148707,PEDRA AZUL,MG,0.562,0.438,5718,4453,10171
3109105,BUENO BRANDÃO,MG,0.257,0.743,1535,4440,5975
3142908,MONTE AZUL,MG,0.625,0.375,7382,4438,11820
3133402,ITAPAGIPE,MG,0.384,0.616,2697,4319,7016
3110707,CAMBUQUIRA,MG,0.341,0.659,2235,4315,6550
3155603,RIO PARDO DE MINAS,MG,0.648,0.352,7930,4311,12241
3108404,BOTELHOS,MG,0.49,0.51,4129,4289,8418
3146909,PAPAGAIOS,MG,0.461,0.539,3673,4289,7962
3104601,ASTOLFO DUTRA,MG,0.439,0.561,3309,4224,7533
3149101,PEDRALVA,MG,0.35,0.65,2256,4198,6454
3132206,ITAGUARA,MG,0.389,0.611,2642,4142,6784
3143005,MONTE BELO,MG,0.415,0.585,2908,4100,7008
3106903,BICAS,MG,0.463,0.537,3512,4066,7578
3145000,NOVA PONTE,MG,0.463,0.537,3508,4062,7570
3140803,MATIAS BARBOSA,MG,0.504,0.496,4128,4061,8189
3122009,DIVINO,MG,0.586,0.414,5695,4025,9720
3114105,CARMO DE MINAS,MG,0.396,0.604,2640,4023,6663
3123908,ENTRE RIOS DE MINAS,MG,0.506,0.494,4108,4017,8125
3124500,ESTIVA,MG,0.343,0.657,2093,4013,6106
3129707,IBIRACI,MG,0.345,0.655,2109,4003,6112
3100906,ÁGUAS FORMOSAS,MG,0.561,0.439,5099,3995,9094
3161007,SÃO DOMINGOS DO PRATA,MG,0.559,0.441,5064,3991,9055
3111507,CAMPOS ALTOS,MG,0.371,0.629,2320,3941,6261
3142205,MIRAÍ,MG,0.422,0.578,2871,3940,6811
3133600,ITAPEVA,MG,0.243,0.757,1259,3923,5182
3157906,SANTA MARGARIDA,MG,0.545,0.455,4685,3906,8591
3139805,MAR DE ESPANHA,MG,0.434,0.566,2990,3904,6894
3136900,JURUAIA,MG,0.319,0.681,1827,3899,5726
3113701,CARLOS CHAGAS,MG,0.567,0.433,5086,3882,8968
3137403,LAGOA DOURADA,MG,0.417,0.583,2764,3872,6636
3124005,ERVÁLIA,MG,0.631,0.369,6593,3854,10447
3161908,SÃO GONÇALO DO RIO ABAIXO,MG,0.476,0.524,3482,3827,7309
3170057,UBAPORANGA,MG,0.392,0.608,2458,3808,6266
3107802,BOM JESUS DO GALHO,MG,0.498,0.502,3754,3778,7532
3161809,SÃO GONÇALO DO PARÁ,MG,0.323,0.677,1801,3777,5578
3131505,IPUIÚNA,MG,0.324,0.676,1802,3763,5565
3109907,CAETANÓPOLIS,MG,0.304,0.696,1640,3748,5388
3157708,SANTA JULIANA,MG,0.416,0.584,2664,3742,6406
3132909,ITAMOGI,MG,0.365,0.635,2146,3737,5883
3168408,TARUMIRIM,MG,0.462,0.538,3184,3712,6896
3112604,CAPINÓPOLIS,MG,0.529,0.471,4143,3689,7832
3120508,CRISTINA,MG,0.313,0.687,1662,3643,5305
3112505,CAPIM BRANCO,MG,0.32,0.68,1713,3641,5354
3159902,SANTO ANTÔNIO DO AMPARO,MG,0.587,0.413,5156,3624,8780
3107901,BOM REPOUSO,MG,0.415,0.585,2568,3621,6189
3132701,ITAMBACURI,MG,0.639,0.361,6375,3602,9977
3125705,FELIXLÂNDIA,MG,0.502,0.498,3621,3587,7208
3166808,SERRA DO SALITRE,MG,0.386,0.614,2242,3559,5801
3126703,FRANCISCO SÁ,MG,0.691,0.309,7970,3558,11528
3159209,SANTA RITA DE CALDAS,MG,0.301,0.699,1518,3526,5044
3155504,RIO PARANAÍBA,MG,0.446,0.554,2831,3519,6350
3117702,CONCEIÇÃO DO RIO VERDE,MG,0.467,0.533,3077,3518,6595
3127008,FRONTEIRA,MG,0.473,0.527,3155,3515,6670
3155702,RIO PIRACICABA,MG,0.54,0.46,4076,3478,7554
3130507,ILICÍNEA,MG,0.475,0.525,3138,3472,6610
3138609,LIMA DUARTE,MG,0.638,0.362,6084,3446,9530
3151305,PIRAÚBA,MG,0.479,0.521,3152,3424,6576
3153608,PRUDENTE DE MORAIS,MG,0.361,0.639,1931,3412,5343
3151107,PIRAPETINGA,MG,0.495,0.505,3331,3392,6723
3109501,CABO VERDE,MG,0.489,0.511,3221,3367,6588
3114006,CARMO DA MATA,MG,0.483,0.517,3137,3355,6492
3123007,DORES DE CAMPOS,MG,0.373,0.627,1996,3350,5346
3153509,ALTO JEQUITIBÁ,MG,0.323,0.677,1589,3337,4926
3141405,MEDINA,MG,0.651,0.349,6181,3315,9496
3120201,CRISTAIS,MG,0.397,0.603,2163,3284,5447
3146305,PADRE PARAÍSO,MG,0.569,0.431,4333,3280,7613
3129301,IAPU,MG,0.408,0.592,2252,3269,5521
3100302,ABRE CAMPO,MG,0.548,0.452,3954,3260,7214
3102803,ANDRELÂNDIA,MG,0.453,0.547,2698,3252,5950
3104106,ARCEBURGO,MG,0.314,0.686,1486,3245,4731
3165008,SÃO TIAGO,MG,0.427,0.573,2418,3241,5659
3118809,CORAÇÃO DE JESUS,MG,0.745,0.255,9403,3221,12624
3117504,CONCEIÇÃO DO MATO DENTRO,MG,0.665,0.335,6322,3189,9511
3145307,NOVO CRUZEIRO,MG,0.73,0.27,8607,3183,11790
3154200,RESENDE COSTA,MG,0.476,0.524,2881,3175,6056
3103900,ARAÚJOS,MG,0.28,0.72,1234,3172,4406
3121100,DELFIM MOREIRA,MG,0.323,0.677,1510,3167,4677
3130200,IGARATINGA,MG,0.358,0.642,1763,3164,4927
3117108,CONCEIÇÃO DA APARECIDA,MG,0.429,0.571,2378,3161,5539
3112802,CAPITÓLIO,MG,0.348,0.652,1675,3139,4814
3154804,RIO ACIMA,MG,0.449,0.551,2552,3130,5682
3151008,PIRANGUINHO,MG,0.36,0.64,1761,3128,4889
3102308,ALVINÓPOLIS,MG,0.632,0.368,5331,3100,8431
3124906,EUGENÓPOLIS,MG,0.475,0.525,2782,3076,5858
3111309,CAMPO DO MEIO,MG,0.521,0.479,3342,3074,6416
3131802,ITABIRINHA,MG,0.431,0.569,2308,3050,5358
3152402,POTÉ,MG,0.564,0.436,3941,3044,6985
3151602,PLANURA,MG,0.429,0.571,2281,3032,5313
3139201,MALACACHETA,MG,0.629,0.371,5125,3026,8151
3134806,JACUÍ,MG,0.233,0.767,919,3020,3939
3133204,ITANHOMI,MG,0.506,0.494,3091,3015,6106
3157336,SANTA CRUZ DE MINAS,MG,0.327,0.673,1464,3011,4475
3139300,MANGA,MG,0.678,0.322,6273,2986,9259
3117876,CONFINS,MG,0.323,0.677,1425,2985,4410
3130606,INCONFIDENTES,MG,0.348,0.652,1593,2985,4578
3108552,BRASILÂNDIA DE MINAS,MG,0.593,0.407,4341,2976,7317
3162203,SÃO JOÃO BATISTA DO GLÓRIA,MG,0.323,0.677,1405,2947,4352
3118700,COQUEIRAL,MG,0.416,0.584,2087,2931,5018
3113909,CARMO DA CACHOEIRA,MG,0.503,0.497,2953,2921,5874
3162559,SÃO JOÃO DO MANHUAÇU,MG,0.526,0.474,3211,2895,6106
3152907,PRATÁPOLIS,MG,0.408,0.592,1999,2895,4894
3169703,TURMALINA,MG,0.704,0.296,6891,2893,9784
3104502,ARINOS,MG,0.633,0.367,4986,2892,7878
3150158,PIEDADE DE CARATINGA,MG,0.391,0.609,1848,2876,4724
3169109,TOLEDO,MG,0.26,0.74,1013,2876,3889
3146503,PAINS,MG,0.385,0.615,1780,2848,4628
3171709,VIRGÍNIA,MG,0.416,0.584,2020,2837,4857
3168903,TIROS,MG,0.223,0.777,815,2832,3647
3164308,SÃO ROQUE DE MINAS,MG,0.247,0.753,927,2830,3757
3168507,TEIXEIRAS,MG,0.573,0.427,3789,2824,6613
3150802,PIRANGA,MG,0.609,0.391,4391,2819,7210
3102902,ANTÔNIO CARLOS,MG,0.565,0.435,3626,2788,6414
3103009,ANTÔNIO DIAS,MG,0.483,0.517,2578,2765,5343
3128907,GUIMARÂNIA,MG,0.357,0.643,1529,2759,4288
3123700,ENGENHEIRO CALDAS,MG,0.429,0.571,2065,2747,4812
3137106,LAGAMAR,MG,0.378,0.622,1666,2741,4407
3143500,MORADA NOVA DE MINAS,MG,0.386,0.614,1713,2728,4441
3154903,RIO CASCA,MG,0.593,0.407,3964,2720,6684
3142601,MONSENHOR PAULO,MG,0.402,0.598,1828,2719,4547
3106408,BELO VALE,MG,0.495,0.505,2656,2705,5361
3148608,PEÇANHA,MG,0.614,0.386,4295,2705,7000
3141009,MATO VERDE,MG,0.617,0.383,4341,2689,7030
3142403,MOEMA,MG,0.351,0.649,1442,2669,4111
3168804,TIRADENTES,MG,0.402,0.598,1764,2629,4393
3150505,PIMENTA,MG,0.397,0.603,1725,2625,4350
3114550,CARNEIRINHO,MG,0.523,0.477,2871,2623,5494
3105301,BANDEIRA DO SUL,MG,0.289,0.711,1061,2609,3670
3143807,MUNHOZ,MG,0.357,0.643,1440,2597,4037
3119203,COROACI,MG,0.484,0.516,2418,2580,4998
3156304,RODEIRO,MG,0.429,0.571,1934,2578,4512
3139706,MARAVILHAS,MG,0.404,0.596,1739,2566,4305
3105004,BALDIM,MG,0.426,0.574,1905,2562,4467
3164605,SÃO SEBASTIÃO DO OESTE,MG,0.447,0.553,2057,2540,4597
3131604,IRAÍ DE MINAS,MG,0.396,0.604,1658,2525,4183
3117603,CONCEIÇÃO DO PARÁ,MG,0.26,0.74,875,2491,3366
3116407,CLARAVAL,MG,0.258,0.742,865,2487,3352
3152600,POUSO ALTO,MG,0.34,0.66,1277,2481,3758
3111804,CANÁPOLIS,MG,0.562,0.438,3176,2475,5651
3167103,SERRO,MG,0.718,0.282,6278,2465,8743
3135803,JEQUITINHONHA,MG,0.755,0.245,7581,2462,10043
3112703,CAPITÃO ENÉAS,MG,0.68,0.32,5233,2457,7690
3162401,SÃO JOÃO DA PONTE,MG,0.802,0.198,9954,2451,12405
3132107,ITACARAMBI,MG,0.69,0.31,5433,2444,7877
3103751,ARAPORÃ,MG,0.42,0.58,1767,2442,4209
3157252,SANTA BÁRBARA DO LESTE,MG,0.455,0.545,2039,2438,4477
3151909,POCRANE,MG,0.472,0.528,2171,2428,4599
3162609,SÃO JOÃO DO ORIENTE,MG,0.48,0.52,2235,2426,4661
3126000,FLORESTAL,MG,0.414,0.586,1711,2426,4137
3127602,GOUVEIA,MG,0.607,0.393,3741,2418,6159
3108107,BONFIM,MG,0.457,0.543,2035,2415,4450
3164407,SÃO SEBASTIÃO DA BELA VISTA,MG,0.345,0.655,1271,2411,3682
3150901,PIRANGUÇU,MG,0.283,0.717,952,2411,3363
3158201,SANTA MARIA DO SUAÇUÍ,MG,0.622,0.378,3963,2409,6372
3121209,DELFINÓPOLIS,MG,0.369,0.631,1406,2406,3812
3142106,MIRADOURO,MG,0.556,0.444,3008,2403,5411
3155405,RIO NOVO,MG,0.497,0.503,2369,2397,4766
3121407,DESTERRO DE ENTRE RIOS,MG,0.362,0.638,1357,2394,3751
3162807,SÃO JOÃO EVANGELISTA,MG,0.679,0.321,5052,2393,7445
3106002,BELA VISTA DE MINAS,MG,0.558,0.442,2997,2374,5371
3102050,ALTO CAPARAÓ,MG,0.251,0.749,789,2350,3139
3165578,SENADOR AMARAL,MG,0.365,0.635,1348,2346,3694
3167806,SOLEDADE DE MINAS,MG,0.329,0.671,1149,2340,3489
3167400,SILVIANÓPOLIS,MG,0.282,0.718,915,2334,3249
3130408,IJACI,MG,0.355,0.645,1282,2334,3616
3134301,ITUMIRIM,MG,0.389,0.611,1488,2333,3821
3165404,SAPUCAÍ-MIRIM,MG,0.321,0.679,1094,2314,3408
3158300,SANTANA DA VARGEM,MG,0.444,0.556,1849,2312,4161
3137536,LAGOA GRANDE,MG,0.519,0.481,2492,2307,4799
3142700,MONTALVÂNIA,MG,0.693,0.307,5201,2305,7506
3147709,PASSA TEMPO,MG,0.485,0.515,2174,2304,4478
3162948,SÃO JOSÉ DA BARRA,MG,0.431,0.569,1742,2302,4044
3170909,VARZELÂNDIA,MG,0.748,0.252,6777,2285,9062
3159357,SANTA RITA DE MINAS,MG,0.402,0.598,1528,2274,3802
3166907,SERRANIA,MG,0.452,0.548,1864,2263,4127
3118908,CORDISBURGO,MG,0.499,0.501,2248,2253,4501
3130309,IGUATAMA,MG,0.466,0.534,1957,2243,4200
3170503,URUCÂNIA,MG,0.589,0.411,3186,2226,5412
3134103,ITUETA,MG,0.33,0.67,1090,2216,3306
3118205,CONQUISTA,MG,0.399,0.601,1469,2212,3681
3141801,MINAS NOVAS,MG,0.799,0.201,8750,2206,10956
3166204,SENHORA DOS REMÉDIOS,MG,0.584,0.416,3087,2201,5288
3125952,FERVEDOURO,MG,0.594,0.406,3215,2200,5415
3152303,PORTO FIRME,MG,0.613,0.387,3479,2197,5676
3170750,VARJÃO DE MINAS,MG,0.411,0.589,1532,2192,3724
3100609,ÁGUA BOA,MG,0.658,0.342,4205,2190,6395
3129004,GUIRICEMA,MG,0.564,0.436,2820,2184,5004
3154101,RECREIO,MG,0.572,0.428,2916,2184,5100
3152709,PRADOS,MG,0.527,0.473,2430,2183,4613
3112406,CAPETINGA,MG,0.391,0.609,1395,2176,3571
3165107,SÃO TOMÁS DE AQUINO,MG,0.403,0.597,1461,2161,3622
3115706,CENTRAL DE MINAS,MG,0.426,0.574,1595,2151,3746
3142007,MIRABELA,MG,0.677,0.323,4509,2147,6656
3158508,SANTANA DE PIRAPAMA,MG,0.527,0.473,2385,2142,4527
3138005,LARANJAL,MG,0.461,0.539,1823,2135,3958
3112901,CAPUTIRA,MG,0.595,0.405,3138,2133,5271
3116506,CLARO DOS POÇÕES,MG,0.536,0.464,2453,2124,4577
3113602,CAREAÇU,MG,0.362,0.638,1203,2120,3323
3100104,ABADIA DOS DOURADOS,MG,0.462,0.538,1821,2117,3938
3128808,GUIDOVAL,MG,0.516,0.484,2251,2114,4365
3165305,SÃO VICENTE DE MINAS,MG,0.419,0.581,1525,2112,3637
3135704,JEQUITIBÁ,MG,0.411,0.589,1470,2104,3574
3100500,AÇUCENA,MG,0.534,0.466,2410,2103,4513
3128402,GUARANI,MG,0.547,0.453,2532,2098,4630
3131000,INHAÚMA,MG,0.403,0.597,1413,2094,3507
3126901,FREI INOCÊNCIO,MG,0.515,0.485,2217,2092,4309
3171808,VIRGINÓPOLIS,MG,0.575,0.425,2821,2084,4905
3101805,ALPERCATA,MG,0.486,0.514,1961,2076,4037
3142304,MOEDA,MG,0.406,0.594,1416,2075,3491
3111408,CAMPO FLORIDO,MG,0.478,0.522,1901,2074,3975
3138674,LUISBURGO,MG,0.437,0.563,1608,2070,3678
3169208,TOMBOS,MG,0.563,0.437,2658,2064,4722
3140530,MARTINS SOARES,MG,0.549,0.451,2488,2047,4535
3124401,ESPÍRITO SANTO DO DOURADO,MG,0.358,0.642,1141,2044,3185
3141603,MERCÊS,MG,0.635,0.365,3538,2032,5570
3160306,SANTO ANTÔNIO DO JACINTO,MG,0.599,0.401,3009,2018,5027
3158003,SANTA MARIA DE ITABIRA,MG,0.624,0.376,3350,2017,5367
3128600,GUARDA-MOR,MG,0.434,0.566,1547,2016,3563
3107505,BOM JARDIM DE MINAS,MG,0.492,0.508,1948,2010,3958
3129202,HELIODORA,MG,0.431,0.569,1522,2008,3530
3149952,PERIQUITO,MG,0.469,0.531,1770,2005,3775
3159506,SANTA RITA DO ITUETO,MG,0.395,0.605,1306,2003,3309
3168101,TAPIRA,MG,0.292,0.708,824,2000,2824
3154150,REDUTO,MG,0.474,0.526,1798,1998,3796
3115805,CENTRALINA,MG,0.596,0.404,2923,1983,4906
3120607,CRUCILÂNDIA,MG,0.385,0.615,1240,1983,3223
3116704,COIMBRA,MG,0.54,0.46,2310,1971,4281
3135506,JEQUERI,MG,0.672,0.328,4040,1969,6009
3166303,SERICITA,MG,0.569,0.431,2598,1968,4566
3109451,CABECEIRA GRANDE,MG,0.425,0.575,1448,1957,3405
3170578,VARGEM ALEGRE,MG,0.464,0.536,1694,1956,3650
3125903,FERROS,MG,0.616,0.384,3117,1940,5057
3161502,SÃO GERALDO,MG,0.572,0.428,2594,1939,4533
3144409,NATÉRCIA,MG,0.279,0.721,749,1938,2687
3156809,SABINÓPOLIS,MG,0.713,0.287,4807,1935,6742
3122504,DOM CAVATI,MG,0.361,0.639,1092,1932,3024
3119955,CÓRREGO FUNDO,MG,0.405,0.595,1311,1927,3238
3127404,GONÇALVES,MG,0.238,0.762,602,1923,2525
3101631,ALFREDO VASCONCELOS,MG,0.504,0.496,1955,1922,3877
3102100,ALTO RIO DOCE,MG,0.686,0.314,4166,1908,6074
3135407,JECEABA,MG,0.487,0.513,1807,1905,3712
3119906,CÓRREGO DO BOM JESUS,MG,0.295,0.705,795,1902,2697
3144508,NAZARENO,MG,0.544,0.456,2272,1901,4173
3122900,DONA EUSÉBIA,MG,0.518,0.482,2038,1900,3938
3121258,DELTA,MG,0.522,0.478,2066,1893,3959
3137007,LADAINHA,MG,0.673,0.327,3900,1893,5793
3123858,ENTRE FOLHAS,MG,0.47,0.53,1657,1870,3527
3109204,BUENÓPOLIS,MG,0.57,0.43,2480,1870,4350
3158904,SANTANA DO MANHUAÇU,MG,0.597,0.403,2764,1867,4631
3127800,GRÃO MOGOL,MG,0.72,0.28,4801,1865,6666
3134707,JACINTO,MG,0.637,0.363,3264,1862,5126
3113503,CARBONITA,MG,0.598,0.402,2774,1861,4635
3162575,SÃO JOÃO DO MANTENINHA,MG,0.44,0.56,1454,1854,3308
3120839,CUPARAQUE,MG,0.282,0.718,726,1853,2579
3113008,CARAÍ,MG,0.76,0.24,5871,1850,7721
3127305,GALILÉIA,MG,0.444,0.556,1475,1844,3319
3148202,PATROCÍNIO DO MURIAÉ,MG,0.485,0.515,1729,1839,3568
3104700,ATALÉIA,MG,0.702,0.298,4321,1836,6157
3129905,IBITIÚRA DE MINAS,MG,0.194,0.806,443,1836,2279
3163201,SÃO JOSÉ DO ALEGRE,MG,0.274,0.726,692,1834,2526
3111903,CANA VERDE,MG,0.433,0.567,1398,1833,3231
3138625,LIMEIRA DO OESTE,MG,0.562,0.438,2345,1831,4176
3132305,ITAIPÉ,MG,0.632,0.368,3126,1818,4944
3171600,VIRGEM DA LAPA,MG,0.663,0.337,3540,1802,5342
3160959,SÃO DOMINGOS DAS DORES,MG,0.47,0.53,1600,1801,3401
3141702,MESQUITA,MG,0.426,0.574,1333,1795,3128
3156007,RIO VERMELHO,MG,0.661,0.339,3483,1784,5267
3164472,SÃO SEBASTIÃO DO ANTA,MG,0.469,0.531,1574,1782,3356
3148756,PEDRA BONITA,MG,0.542,0.458,2084,1763,3847
3122405,DIVISA NOVA,MG,0.478,0.522,1609,1760,3369
3120706,CRUZEIRO DA FORTALEZA,MG,0.36,0.64,989,1759,2748
3121803,DIONÍSIO,MG,0.543,0.457,2087,1755,3842
3168309,TAQUARAÇU DE MINAS,MG,0.348,0.652,935,1751,2686
3152170,PONTO DOS VOLANTES,MG,0.654,0.346,3304,1748,5052
3131109,INIMUTABA,MG,0.544,0.456,2083,1747,3830
3150604,PIRACEMA,MG,0.561,0.439,2221,1739,3960
3165701,SENADOR FIRMINO,MG,0.599,0.401,2591,1734,4325
3140555,MATA VERDE,MG,0.576,0.424,2348,1730,4078
3123528,DURANDÉ,MG,0.593,0.407,2517,1729,4246
3150406,PIEDADE DOS GERAIS,MG,0.424,0.576,1268,1720,2988
3127206,FUNILÂNDIA,MG,0.383,0.617,1063,1712,2775
3101201,AIURUOCA,MG,0.45,0.55,1393,1701,3094
3148301,PAULA CÂNDIDO,MG,0.663,0.337,3330,1696,5026
3155306,RIO MANSO,MG,0.451,0.549,1395,1696,3091
3124807,ESTRELA DO SUL,MG,0.552,0.448,2081,1687,3768
3161205,SÃO FRANCISCO DE PAULA,MG,0.558,0.442,2123,1681,3804
3128204,GUARACIABA,MG,0.665,0.335,3337,1680,5017
3164506,SÃO SEBASTIÃO DO MARANHÃO,MG,0.613,0.387,2625,1657,4282
3120409,CRISTIANO OTONI,MG,0.429,0.571,1232,1638,2870
3136504,JORDÂNIA,MG,0.64,0.36,2911,1636,4547
3135902,JESUÂNIA,MG,0.403,0.597,1102,1634,2736
3144359,NAQUE,MG,0.497,0.503,1611,1633,3244
3161700,SÃO GONÇALO DO ABAETÉ,MG,0.484,0.516,1530,1629,3159
3107604,BOM JESUS DA PENHA,MG,0.288,0.712,657,1627,2284
3163904,SÃO PEDRO DA UNIÃO,MG,0.393,0.607,1050,1625,2675
3145877,ORIZÂNIA,MG,0.604,0.396,2481,1625,4106
3122207,DIVINOLÂNDIA DE MINAS,MG,0.521,0.479,1761,1622,3383
3109253,BUGRE,MG,0.387,0.613,1020,1616,2636
3136603,NOVA UNIÃO,MG,0.525,0.475,1781,1612,3393
3112109,CAPARAÓ,MG,0.441,0.559,1266,1604,2870
3107208,BOCAINA DE MINAS,MG,0.457,0.543,1345,1600,2945
3101003,ÁGUAS VERMELHAS,MG,0.716,0.284,4014,1592,5606
3115359,CATAS ALTAS,MG,0.465,0.535,1382,1591,2973
3134004,ITINGA,MG,0.757,0.243,4933,1585,6518
3129103,GURINHATÃ,MG,0.491,0.509,1522,1578,3100
3130655,INDAIABIRA,MG,0.548,0.452,1899,1564,3463
3133907,ITAVERAVA,MG,0.576,0.424,2126,1564,3690
3148905,PEDRA DO INDAIÁ,MG,0.327,0.673,759,1563,2322
3122108,DIVINO DAS LARANJEIRAS,MG,0.43,0.57,1177,1562,2739
3169505,TUMIRITINGA,MG,0.526,0.474,1731,1558,3289
3116001,CHALÉ,MG,0.537,0.463,1793,1549,3342
3158805,SANTANA DO JACARÉ,MG,0.385,0.615,965,1541,2506
3160801,SÃO BENTO ABADE,MG,0.412,0.588,1075,1537,2612
3144656,NINHEIRA,MG,0.624,0.376,2546,1535,4081
3169802,TURVOLÂNDIA,MG,0.414,0.586,1081,1527,2608
3140308,MARLIÉRIA,MG,0.45,0.55,1251,1526,2777
3162302,SÃO JOÃO DA MATA,MG,0.286,0.714,611,1523,2134
3121308,DESCOBERTO,MG,0.513,0.487,1586,1508,3094
3130556,IMBÉ DE MINAS,MG,0.585,0.415,2119,1506,3625
3146206,OURO VERDE DE MINAS,MG,0.592,0.408,2185,1503,3688
3130705,INDIANÓPOLIS,MG,0.511,0.489,1567,1501,3068
3116159,CHAPADA GAÚCHA,MG,0.713,0.287,3729,1501,5230
3146701,PALMA,MG,0.59,0.41,2147,1492,3639
3136009,JOAÍMA,MG,0.75,0.25,4454,1488,5942
3141504,MENDES PIMENTEL,MG,0.544,0.456,1776,1487,3263
3102852,ANGELÂNDIA,MG,0.566,0.434,1938,1485,3423
3105509,BARÃO DE MONTE ALTO,MG,0.607,0.393,2287,1480,3767
3169059,TOCOS DO MOJI,MG,0.455,0.545,1232,1475,2707
3149606,PEQUI,MG,0.389,0.611,939,1472,2411
3145802,ONÇA DE PITANGUI,MG,0.321,0.679,692,1467,2159
3150703,PIRAJUBA,MG,0.478,0.522,1338,1463,2801
3109600,CACHOEIRA DA PRATA,MG,0.401,0.599,978,1461,2439
3159001,SANTANA DO RIACHO,MG,0.515,0.485,1551,1458,3009
3172202,WENCESLAU BRAZ,MG,0.261,0.739,516,1458,1974
3120870,CURRAL DE DENTRO,MG,0.592,0.408,2113,1457,3570
3127503,GONZAGA,MG,0.431,0.569,1102,1456,2558
3136108,JOANÉSIA,MG,0.461,0.539,1245,1455,2700
3167707,SOBRÁLIA,MG,0.469,0.531,1281,1452,2733
3114709,CARVALHÓPOLIS,MG,0.365,0.635,830,1443,2273
3163102,SÃO JOSÉ DA VARGINHA,MG,0.38,0.62,883,1438,2321
3159308,SANTA RITA DE JACUTINGA,MG,0.523,0.477,1573,1435,3008
3103801,ARAPUÁ,MG,0.286,0.714,573,1434,2007
3102209,ALVARENGA,MG,0.509,0.491,1473,1422,2895
3171154,VERMELHO NOVO,MG,0.535,0.465,1638,1421,3059
3101409,ALBERTINA,MG,0.199,0.801,352,1419,1771
3164001,SÃO PEDRO DOS FERROS,MG,0.639,0.361,2505,1417,3922
3114808,CARVALHOS,MG,0.426,0.574,1051,1414,2465
3126208,FORMOSO,MG,0.624,0.376,2348,1414,3762
3112653,CAPITÃO ANDRADE,MG,0.441,0.559,1115,1414,2529
3138302,LEANDRO FERREIRA,MG,0.359,0.641,792,1412,2204
3163805,SÃO MIGUEL DO ANTA,MG,0.655,0.345,2670,1405,4075
3102704,CACHOEIRA DE PAJEÚ,MG,0.658,0.342,2698,1403,4101
3107703,BOM JESUS DO AMPARO,MG,0.549,0.451,1708,1401,3109
3138708,LUMINÁRIAS,MG,0.505,0.495,1427,1400,2827
3155900,RIO PRETO,MG,0.61,0.39,2188,1400,3588
3100807,AGUANIL,MG,0.436,0.564,1080,1399,2479
3135308,JAPARAÍBA,MG,0.392,0.608,898,1394,2292
3155207,RIO ESPERA,MG,0.578,0.422,1905,1392,3297
3166709,SERRA DOS AIMORÉS,MG,0.58,0.42,1899,1375,3274
3170651,VARGEM GRANDE DO RIO PARDO,MG,0.468,0.532,1207,1374,2581
3145059,NOVA PORTEIRINHA,MG,0.65,0.35,2539,1366,3905
3126307,FORTALEZA DE MINAS,MG,0.317,0.683,631,1360,1991
3156106,RITÁPOLIS,MG,0.527,0.473,1499,1347,2846
3156452,ROSÁRIO DA LIMEIRA,MG,0.593,0.407,1962,1346,3308
3141207,MATUTINA,MG,0.373,0.627,798,1343,2141
3127388,GOIANÁ,MG,0.47,0.53,1188,1342,2530
3170529,URUCUIA,MG,0.703,0.297,3170,1341,4511
3134509,ITUTINGA,MG,0.445,0.555,1074,1338,2412
3116803,COLUNA,MG,0.649,0.351,2463,1331,3794
3123304,DORES DO TURVO,MG,0.583,0.417,1854,1327,3181
3141900,MINDURI,MG,0.365,0.635,763,1326,2089
3139102,MADRE DE DEUS DE MINAS,MG,0.534,0.466,1516,1322,2838
3145356,NOVO ORIENTE DE MINAS,MG,0.715,0.285,3303,1315,4618
3122801,DOM VIÇOSO,MG,0.347,0.653,693,1302,1995
3165503,SARDOÁ,MG,0.515,0.485,1375,1295,2670
3165206,SÃO THOMÉ DAS LETRAS,MG,0.589,0.411,1848,1291,3139
3158409,SANTANA DE CATAGUASES,MG,0.446,0.554,1034,1284,2318
3138906,MACHACALIS,MG,0.639,0.361,2261,1280,3541
3161304,SÃO FRANCISCO DE SALES,MG,0.615,0.385,2042,1280,3322
3122355,DIVISA ALEGRE,MG,0.554,0.446,1586,1278,2864
3122454,DIVISÓPOLIS,MG,0.692,0.308,2856,1272,4128
3162450,SÃO JOÃO DAS MISSÕES,MG,0.777,0.223,4425,1271,5696
3126505,FRANCISCO BADARÓ,MG,0.66,0.34,2468,1270,3738
3108206,BONFINÓPOLIS DE MINAS,MG,0.578,0.422,1736,1267,3003
3170008,UBAÍ,MG,0.768,0.232,4193,1266,5459
3116308,CIPOTÂNEA,MG,0.577,0.423,1725,1263,2988
3135001,JAGUARAÇU,MG,0.395,0.605,823,1260,2083
3130051,ICARAÍ DE MINAS,MG,0.753,0.247,3828,1259,5087
3146404,PAINEIRAS,MG,0.524,0.476,1383,1254,2637
3115201,CONCEIÇÃO DA BARRA DE MINAS,MG,0.468,0.532,1098,1249,2347
3167905,TABULEIRO,MG,0.545,0.455,1490,1244,2734
3141306,MEDEIROS,MG,0.379,0.621,759,1243,2002
3115458,CATUJI,MG,0.731,0.269,3374,1242,4616
3148509,PAVÃO,MG,0.65,0.35,2306,1239,3545
3138500,LIBERDADE,MG,0.566,0.434,1604,1228,2832
3127370,GOIABEIRA,MG,0.361,0.639,689,1218,1907
3108800,BRAÚNAS,MG,0.527,0.473,1356,1216,2572
3115003,CASCALHO RICO,MG,0.419,0.581,878,1215,2093
3149200,PEDRINÓPOLIS,MG,0.431,0.569,916,1208,2124
3154408,RESSAQUINHA,MG,0.596,0.404,1776,1206,2982
3153004,PRATINHA,MG,0.347,0.653,641,1205,1846
3125200,FAMA,MG,0.366,0.634,693,1203,1896
3163300,SÃO JOSÉ DO DIVINO,MG,0.443,0.557,953,1197,2150
3154705,RIBEIRÃO VERMELHO,MG,0.448,0.552,967,1193,2160
3125408,FELÍCIO DOS SANTOS,MG,0.525,0.475,1317,1191,2508
3138104,LASSANCE,MG,0.639,0.361,2086,1179,3265
3161056,SÃO FÉLIX DE MINAS,MG,0.457,0.543,992,1178,2170
3124708,ESTRELA DO INDAIÁ,MG,0.35,0.65,631,1171,1802
3139250,MAMONAS,MG,0.688,0.312,2579,1169,3748
3108701,BRÁS PIRES,MG,0.55,0.45,1426,1166,2592
3101300,ALAGOA,MG,0.284,0.716,462,1165,1627
3166006,SENHORA DE OLIVEIRA,MG,0.67,0.33,2356,1160,3516
3154507,RIACHO DOS MACHADOS,MG,0.733,0.267,3166,1152,4318
3132602,ITAMARATI DE MINAS,MG,0.535,0.465,1322,1150,2472
3135605,JEQUITAÍ,MG,0.68,0.32,2440,1148,3588
3160009,SANTO ANTÔNIO DO AVENTUREIRO,MG,0.512,0.488,1205,1148,2353
3153103,PRESIDENTE BERNARDES,MG,0.647,0.353,2101,1145,3246
3121506,DESTERRO DO MELO,MG,0.493,0.507,1112,1142,2254
3150307,PIEDADE DO RIO GRANDE,MG,0.529,0.471,1275,1137,2412
3140209,MARIPÁ DE MINAS,MG,0.458,0.542,956,1132,2088
3122470,DOM BOSCO,MG,0.472,0.528,1012,1131,2143
3112208,CAPELA NOVA,MG,0.586,0.414,1600,1130,2730
3128501,GUARARÁ,MG,0.505,0.495,1150,1128,2278
3122702,DOM SILVÉRIO,MG,0.611,0.389,1756,1120,2876
3106507,BERILO,MG,0.76,0.24,3534,1118,4652
3159100,SANTANA DOS MONTES,MG,0.53,0.47,1257,1115,2372
3119807,CÓRREGO DANTA,MG,0.406,0.594,763,1114,1877
3161403,SÃO FRANCISCO DO GLÓRIA,MG,0.612,0.388,1749,1110,2859
3138658,LONTRA,MG,0.766,0.234,3635,1109,4744
3119500,CORONEL MURTA,MG,0.748,0.252,3276,1104,4380
3172103,VOLTA GRANDE,MG,0.602,0.398,1662,1098,2760
3114600,CARRANCAS,MG,0.497,0.503,1087,1098,2185
3140407,MARMELÓPOLIS,MG,0.411,0.589,762,1091,1853
3156601,RUBIM,MG,0.711,0.289,2673,1085,3758
3171402,VIEIRAS,MG,0.578,0.422,1484,1082,2566
3116209,CHIADOR,MG,0.44,0.56,851,1082,1933
3125804,FERNANDES TOURINHO,MG,0.363,0.637,614,1077,1691
3164100,SÃO PEDRO DO SUAÇUÍ,MG,0.606,0.394,1636,1064,2700
3165800,SENADOR JOSÉ BENTO,MG,0.307,0.693,472,1064,1536
3105707,BARRA LONGA,MG,0.681,0.319,2272,1063,3335
3116902,COMENDADOR GOMES,MG,0.395,0.605,691,1060,1751
3123106,DORES DE GUANHÃES,MG,0.641,0.359,1890,1059,2949
3104809,AUGUSTO DE LIMA,MG,0.565,0.435,1367,1053,2420
3154457,RIACHINHO,MG,0.687,0.313,2314,1052,3366
3153707,QUARTEL GERAL,MG,0.481,0.519,973,1049,2022
3144672,NOVA BELÉM,MG,0.528,0.472,1172,1049,2221
3146750,PALMÓPOLIS,MG,0.68,0.32,2222,1048,3270
3130804,INGAÍ,MG,0.448,0.552,837,1033,1870
3123809,ENGENHEIRO NAVARRO,MG,0.725,0.275,2719,1033,3752
3163409,SÃO JOSÉ DO GOIABAL,MG,0.638,0.362,1803,1025,2828
3160900,SÃO BRÁS DO SUAÇUÍ,MG,0.505,0.495,1047,1025,2072
3150539,PINGO D'ÁGUA,MG,0.575,0.425,1388,1024,2412
3145372,NOVORIZONTE,MG,0.625,0.375,1705,1023,2728
3161601,SÃO GERALDO DA PIEDADE,MG,0.541,0.459,1202,1020,2222
3157104,SALTO DA DIVISA,MG,0.648,0.352,1876,1018,2894
3163003,SÃO JOSÉ DA SAFIRA,MG,0.558,0.442,1285,1016,2301
3113107,CARANAÍBA,MG,0.486,0.514,961,1015,1976
3143450,MONTEZUMA,MG,0.7,0.3,2369,1014,3383
3110103,CAIANA,MG,0.611,0.389,1594,1014,2608
3121902,DIVINÉSIA,MG,0.63,0.37,1724,1013,2737
3136801,JURAMENTO,MG,0.658,0.342,1937,1005,2942
3157401,SANTA CRUZ DO ESCALVADO,MG,0.674,0.326,2081,1005,3086
3129400,IBERTIOGA,MG,0.699,0.301,2326,1003,3329
3117207,CONCEIÇÃO DAS PEDRAS,MG,0.434,0.566,766,997,1763
3164209,SÃO ROMÃO,MG,0.729,0.271,2669,992,3661
3100708,ÁGUA COMPRIDA,MG,0.347,0.653,526,991,1517
3136959,JUVENÍLIA,MG,0.7,0.3,2315,991,3306
3125002,EWBANK DA CÂMARA,MG,0.642,0.358,1776,991,2767
3159704,SANTA ROSA DA SERRA,MG,0.498,0.502,982,990,1972
3163508,SÃO JOSÉ DO JACURI,MG,0.66,0.34,1919,990,2909
3126604,FRANCISCO DUMONT,MG,0.598,0.402,1471,989,2460
3170479,URUANA DE MINAS,MG,0.518,0.482,1059,987,2046
3149507,PEQUERI,MG,0.527,0.473,1095,983,2078
3168051,TAPARUBA,MG,0.539,0.461,1149,981,2130
3114907,CASA GRANDE,MG,0.435,0.565,754,980,1734
3125606,FELISBURGO,MG,0.687,0.313,2145,978,3123
3110202,CAJURI,MG,0.67,0.33,1986,976,2962
3161650,SÃO GERALDO DO BAIXIO,MG,0.508,0.492,1008,975,1983
3117405,CONCEIÇÃO DE IPANEMA,MG,0.629,0.371,1653,973,2626
3140100,MARILAC,MG,0.594,0.406,1419,969,2388
3119609,CORONEL PACHECO,MG,0.497,0.503,952,963,1915
3164902,SÃO SEBASTIÃO DO RIO VERDE,MG,0.299,0.701,408,956,1364
3115409,CATAS ALTAS DA NORUEGA,MG,0.577,0.423,1303,955,2258
3156403,ROMARIA,MG,0.556,0.444,1197,954,2151
3126406,FORTUNA DE MINAS,MG,0.505,0.495,968,949,1917
3103702,ARAPONGA,MG,0.773,0.227,3228,947,4175
3167509,SIMÃO PEREIRA,MG,0.517,0.483,1012,945,1957
3107000,BIQUINHAS,MG,0.444,0.556,746,934,1680
3171030,VERDELÂNDIA,MG,0.764,0.236,3015,929,3944
3115904,CHÁCARA,MG,0.541,0.459,1089,923,2012
3144904,NOVA MÓDICA,MG,0.586,0.414,1301,921,2222
3171105,VERÍSSIMO,MG,0.486,0.514,868,919,1787
3135357,JAPONVAR,MG,0.804,0.196,3757,916,4673
3110400,CAMACHO,MG,0.578,0.422,1245,908,2153
3157500,SANTA EFIGÊNIA DE MINAS,MG,0.584,0.416,1267,903,2170
3117009,COMERCINHO,MG,0.766,0.234,2951,902,3853
3137304,LAGOA DOS PATOS,MG,0.596,0.404,1324,899,2223
3158102,SANTA MARIA DO SALTO,MG,0.624,0.376,1491,898,2389
3119005,CORDISLÂNDIA,MG,0.496,0.504,882,895,1777
3171071,VEREDINHA,MG,0.714,0.286,2229,893,3122
3158607,SANTANA DO DESERTO,MG,0.613,0.387,1413,893,2306
3162252,SÃO JOÃO DA LAGOA,MG,0.696,0.304,2042,892,2934
3119708,CORONEL XAVIER CHAVES,MG,0.542,0.458,1056,892,1948
3130002,IBITURUNA,MG,0.435,0.565,684,889,1573
3150109,PIAU,MG,0.561,0.439,1127,882,2009
3153806,QUELUZITO,MG,0.461,0.539,750,878,1628
3149150,PEDRAS DE MARIA DA CRUZ,MG,0.807,0.193,3656,876,4532
3150570,PINTÓPOLIS,MG,0.758,0.242,2731,871,3602
3131406,IPIAÇU,MG,0.595,0.405,1281,871,2152
3156205,ROCHEDO DE MINAS,MG,0.454,0.546,724,870,1594
3157278,SANTA BÁRBARA DO MONTE VERDE,MG,0.597,0.403,1287,868,2155
3122603,DOM JOAQUIM,MG,0.626,0.374,1448,865,2313
3111705,CANAÃ,MG,0.709,0.291,2099,862,2961
3163607,SÃO JOSÉ DO MANTIMENTO,MG,0.527,0.473,961,861,1822
3166105,SENHORA DO PORTO,MG,0.533,0.467,982,861,1843
3160108,SANTO ANTÔNIO DO GRAMA,MG,0.651,0.349,1603,860,2463
3103207,ARAÇAÍ,MG,0.443,0.557,684,860,1544
3140852,MATIAS CARDOSO,MG,0.782,0.218,3074,859,3933
3136405,JOAQUIM FELÍCIO,MG,0.559,0.441,1089,859,1948
3170602,VARGEM BONITA,MG,0.401,0.599,573,855,1428
3171907,VIRGOLÂNDIA,MG,0.676,0.324,1775,851,2626
3157302,SANTA BÁRBARA DO TUGÚRIO,MG,0.714,0.286,2109,845,2954
3135076,JAMPRUCA,MG,0.672,0.328,1727,842,2569
3126752,FRANCISCÓPOLIS,MG,0.669,0.331,1697,840,2537
3171501,MATHIAS LOBATO,MG,0.528,0.472,937,837,1774
3150000,PESCADOR,MG,0.598,0.402,1234,830,2064
3165909,SENADOR MODESTINO GONÇALVES,MG,0.653,0.347,1563,829,2392
3102506,AMPARO DO SERRA,MG,0.726,0.274,2161,817,2978
3127339,GAMELEIRAS,MG,0.709,0.291,1985,814,2799
3125309,FARIA LEMOS,MG,0.599,0.401,1207,809,2016
3150208,PIEDADE DE PONTE NOVA,MG,0.662,0.338,1583,808,2391
3145505,OLÍMPIO NORONHA,MG,0.509,0.491,836,807,1643
3126802,FREI GASPAR,MG,0.72,0.28,2048,797,2845
3106606,BERTÓPOLIS,MG,0.682,0.318,1704,796,2500
3118502,CONSOLAÇÃO,MG,0.319,0.681,373,796,1169
3166956,SERRANÓPOLIS DE MINAS,MG,0.687,0.313,1742,792,2534
3147808,PASSA VINTE,MG,0.445,0.555,633,791,1424
3136553,JOSÉ RAYDAN,MG,0.653,0.347,1485,790,2275
3129608,IBIAÍ,MG,0.785,0.215,2879,787,3666
3100401,ACAIACA,MG,0.638,0.362,1377,782,2159
3164431,SÃO SEBASTIÃO DA VARGEM ALEGRE,MG,0.577,0.423,1062,777,1839
3138351,LEME DO PRADO,MG,0.671,0.329,1581,776,2357
3127354,GLAUCILÂNDIA,MG,0.678,0.322,1624,773,2397
3153202,PRESIDENTE JUSCELINO,MG,0.651,0.349,1443,772,2215
3135456,JENIPAPO DE MINAS,MG,0.716,0.284,1948,772,2720
3170438,UNIÃO DE MINAS,MG,0.633,0.367,1327,771,2098
3116100,CHAPADA DO NORTE,MG,0.835,0.165,3895,767,4662
3146552,PAI PEDRO,MG,0.757,0.243,2380,762,3142
3104452,ARICANDUVA,MG,0.715,0.285,1907,759,2666
3137908,LAMIM,MG,0.662,0.338,1473,753,2226
3129657,IBIRACATU,MG,0.775,0.225,2585,751,3336
3145851,ORATÓRIOS,MG,0.723,0.277,1950,746,2696
3156502,RUBELITA,MG,0.808,0.192,3146,746,3892
3157658,SANTA HELENA DE MINAS,MG,0.747,0.253,2189,742,2931
3121001,DATAS,MG,0.739,0.261,2090,739,2829
3110806,CAMPANÁRIO,MG,0.621,0.379,1195,728,1923
3165552,SETUBINHA,MG,0.828,0.172,3501,725,4226
3112059,CANTAGALO,MG,0.655,0.345,1367,721,2088
3108503,BOTUMIRIM,MG,0.76,0.24,2278,719,2997
3106101,BELMIRO BRAGA,MG,0.655,0.345,1368,719,2087
3145455,OLHOS-D'ÁGUA,MG,0.771,0.229,2387,708,3095
3120003,CÓRREGO NOVO,MG,0.651,0.349,1313,705,2018
3160454,SANTO ANTÔNIO DO RETIRO,MG,0.798,0.202,2756,699,3455
3103603,ARANTINA,MG,0.608,0.392,1081,697,1778
3104403,ARGIRITA,MG,0.627,0.373,1154,687,1841
3149002,PEDRA DOURADA,MG,0.6,0.4,1032,687,1719
3106804,BIAS FORTES,MG,0.707,0.293,1645,681,2326
3108255,BONITO DE MINAS,MG,0.846,0.154,3741,680,4421
3103108,ANTÔNIO PRADO DE MINAS,MG,0.506,0.494,692,675,1367
3144375,NATALÂNDIA,MG,0.649,0.351,1247,674,1921
3165602,SENADOR CORTES,MG,0.579,0.421,920,670,1590
3167004,SERRANOS,MG,0.483,0.517,626,669,1295
3143708,MORRO DO PILAR,MG,0.663,0.337,1312,668,1980
3148806,PEDRA DO ANTA,MG,0.706,0.294,1598,665,2263
3155009,RIO DOCE,MG,0.572,0.428,886,664,1550
3124609,ESTRELA DALVA,MG,0.58,0.42,912,660,1572
3120151,CRISÓLITA,MG,0.769,0.231,2182,656,2838
3115474,CATUTI,MG,0.759,0.241,2054,653,2707
3126950,FREI LAGONEGRO,MG,0.681,0.319,1393,652,2045
3128253,GUARACIAMA,MG,0.803,0.197,2648,651,3299
3121704,DIOGO DE VASCONCELOS,MG,0.734,0.266,1788,648,2436
3106655,BERIZAL,MG,0.732,0.268,1768,647,2415
3127909,GRUPIARA,MG,0.403,0.597,435,645,1080
3146255,PADRE CARVALHO,MG,0.746,0.254,1884,640,2524
3132800,ITAMBÉ DO MATO DENTRO,MG,0.563,0.437,825,640,1465
3120300,CRISTÁLIA,MG,0.777,0.223,2217,638,2855
3136520,JOSÉ GONÇALVES DE MINAS,MG,0.687,0.313,1384,632,2016
3167301,SILVEIRÂNIA,MG,0.662,0.338,1238,631,1869
3118106,CONGONHAS DO NORTE,MG,0.714,0.286,1554,623,2177
3148400,PAULISTAS,MG,0.741,0.259,1766,618,2384
3159407,SANTA RITA DE IBITIPOCA,MG,0.697,0.303,1417,617,2034
3143153,MONTE FORMOSO,MG,0.744,0.256,1784,613,2397
3147956,PATIS,MG,0.796,0.204,2376,608,2984
3123502,DOURADOQUARA,MG,0.53,0.47,681,605,1286
3166402,SERITINGA,MG,0.462,0.538,514,599,1113
3113800,CARMÉSIA,MG,0.53,0.47,674,597,1271
3132008,ITACAMBIRA,MG,0.776,0.224,2049,593,2642
3123403,DORESÓPOLIS,MG,0.453,0.547,482,582,1064
3102407,ALVORADA DE MINAS,MG,0.744,0.256,1662,573,2235
3165560,SEM-PEIXE,MG,0.679,0.321,1213,573,1786
3138682,LUISLÂNDIA,MG,0.847,0.153,3156,570,3726
3120102,COUTO DE MAGALHÃES DE MINAS,MG,0.74,0.26,1613,567,2180
3117836,CÔNEGO MARINHO,MG,0.848,0.152,3152,566,3718
3125507,SÃO GONÇALO DO RIO PRETO,MG,0.663,0.337,1105,561,1666
3144201,NACIP RAYDAN,MG,0.658,0.342,1075,558,1633
3140605,MATERLÂNDIA,MG,0.747,0.253,1602,543,2145
3168200,TAPIRAÍ,MG,0.54,0.46,633,540,1173
3166501,SERRA AZUL DE MINAS,MG,0.703,0.297,1278,540,1818
3103306,ARACITABA,MG,0.596,0.404,794,539,1333
3155108,RIO DO PRADO,MG,0.79,0.21,2018,536,2554
3127057,FRONTEIRA DOS VALES,MG,0.78,0.22,1891,534,2425
3147501,PASSABÉM,MG,0.515,0.485,563,531,1094
3142254,MIRAVÂNIA,MG,0.757,0.243,1623,522,2145
3162658,SÃO JOÃO DO PACUÍ,MG,0.776,0.224,1797,520,2317
3142502,MONJOLOS,MG,0.61,0.39,813,519,1332
3109808,CACHOEIRA DOURADA,MG,0.65,0.35,956,515,1471
3143609,MORRO DA GARÇA,MG,0.69,0.31,1137,511,1648
3105202,BANDEIRA,MG,0.797,0.203,1988,506,2494
3152131,PONTO CHIQUE,MG,0.764,0.236,1632,505,2137
3127073,FRUTA DE LEITE,MG,0.797,0.203,1976,503,2479
3145406,OLARIA,MG,0.654,0.346,938,497,1435
3164803,SÃO SEBASTIÃO DO RIO PRETO,MG,0.47,0.53,425,479,904
3115607,CEDRO DO ABAETÉ,MG,0.339,0.661,237,462,699
3160603,SANTO HIPÓLITO,MG,0.713,0.287,1141,460,1601
3166600,SERRA DA SAUDADE,MG,0.274,0.726,172,456,628
3160207,SANTO ANTÔNIO DO ITAMBÉ,MG,0.747,0.253,1337,454,1791
3111150,CAMPO AZUL,MG,0.796,0.204,1763,453,2216
3170305,UMBURATIBA,MG,0.706,0.294,1088,452,1540
3136579,JOSENÓPOLIS,MG,0.743,0.257,1302,451,1753
3160504,SANTO ANTÔNIO DO RIO ABAIXO,MG,0.611,0.389,706,450,1156
3145703,OLIVEIRA FORTES,MG,0.707,0.293,1068,443,1511
3158706,SANTANA DO GARAMBÉU,MG,0.7,0.3,1028,440,1468
3149408,PEDRO TEIXEIRA,MG,0.732,0.268,1188,435,1623
3146602,PAIVA,MG,0.613,0.387,673,425,1098
3157609,SANTA FÉ DE MINAS,MG,0.761,0.239,1349,424,1773
3157377,SANTA CRUZ DE SALINAS,MG,0.83,0.17,2034,418,2452
3153301,PRESIDENTE KUBITSCHEK,MG,0.795,0.205,1360,351,1711
1501402,BELÉM,PA,0.451,0.549,351193,427982,779175
1500800,ANANINDEUA,PA,0.453,0.547,109713,132590,242303
1506807,SANTARÉM,PA,0.436,0.564,70119,90577,160696
1505536,PARAUAPEBAS,PA,0.385,0.615,40410,64650,105060
1504208,MARABÁ,PA,0.441,0.559,48278,61220,109498
1502400,CASTANHAL,PA,0.452,0.548,42925,52067,94992
1500602,ALTAMIRA,PA,0.367,0.633,19466,33549,53015
1505502,PARAGOMINAS,PA,0.419,0.581,19464,27031,46495
1504422,MARITUBA,PA,0.544,0.456,30049,25234,55283
1506138,REDENÇÃO,PA,0.337,0.663,12661,24929,37590
1503606,ITAITUBA,PA,0.443,0.557,19715,24784,44499
1508100,TUCURUÍ,PA,0.549,0.451,26569,21854,48423
1501709,BRAGANÇA,PA,0.632,0.368,36553,21245,57798
1501303,BARCARENA,PA,0.663,0.337,41225,20998,62223
1500107,ABAETETUBA,PA,0.756,0.244,61646,19896,81542
1504802,MONTE ALEGRE,PA,0.486,0.514,15297,16203,31500
1502103,CAMETÁ,PA,0.758,0.242,49947,15959,65906
1502202,CAPANEMA,PA,0.57,0.43,20189,15253,35442
1502152,CANAÃ DOS CARAJÁS,PA,0.379,0.621,9048,14842,23890
1506500,SANTA IZABEL DO PARÁ,PA,0.547,0.453,17253,14312,31565
1508407,XINGUARA,PA,0.373,0.627,8033,13477,21510
1507953,TAILÂNDIA,PA,0.558,0.442,16910,13392,30302
1501501,BENEVIDES,PA,0.548,0.452,16177,13337,29514
1507300,SÃO FÉLIX DO XINGU,PA,0.399,0.601,8727,13133,21860
1500404,ALENQUER,PA,0.526,0.474,14397,12988,27385
1501808,BREVES,PA,0.676,0.324,25035,12011,37046
1508159,URUARÁ,PA,0.333,0.667,5993,11999,17992
1502707,CONCEIÇÃO DO ARAGUAIA,PA,0.459,0.541,9945,11724,21669
1508001,TOMÉ-AÇU,PA,0.629,0.371,19586,11569,31155
1505064,NOVO REPARTIMENTO,PA,0.522,0.478,12573,11506,24079
1505304,ORIXIMINÁ,PA,0.587,0.413,16020,11263,27283
1508084,TUCUMÃ,PA,0.373,0.627,6298,10585,16883
1502301,CAPITÃO POÇO,PA,0.635,0.365,17366,9979,27345
1503309,IGARAPÉ-MIRI,PA,0.695,0.305,21804,9576,31380
1505031,NOVO PROGRESSO,PA,0.218,0.782,2638,9454,12092
1506187,RONDON DO PARÁ,PA,0.483,0.517,8530,9123,17653
1507607,SÃO MIGUEL DO GUAMÁ,PA,0.655,0.345,16700,8788,25488
1503903,JURUTI,PA,0.603,0.397,13294,8755,22049
1503804,JACUNDÁ,PA,0.591,0.409,12043,8318,20361
1504703,MOJU,PA,0.759,0.241,26114,8296,34410
1502939,DOM ELISEU,PA,0.563,0.437,10573,8200,18773
1506203,SALINÓPOLIS,PA,0.645,0.355,14318,7897,22215
1501782,BREU BRANCO,PA,0.593,0.407,11310,7772,19082
1506708,SANTANA DO ARAGUAIA,PA,0.409,0.591,5241,7561,12802
1500206,ACARÁ,PA,0.749,0.251,22544,7548,30092
1505486,PACAJÁ,PA,0.519,0.481,8037,7460,15497
1508209,VIGIA,PA,0.692,0.308,16549,7361,23910
1505437,OURILÂNDIA DO NORTE,PA,0.443,0.557,5816,7299,13115
1504752,MOJUÍ DOS CAMPOS,PA,0.444,0.556,5744,7192,12936
1504059,MÃE DO RIO,PA,0.555,0.445,8853,7101,15954
1504455,MEDICILÂNDIA,PA,0.379,0.621,4329,7085,11414
1503705,ITUPIRANGA,PA,0.644,0.356,12266,6785,19051
1505106,ÓBIDOS,PA,0.709,0.291,16517,6781,23298
1501725,BRASIL NOVO,PA,0.381,0.619,4132,6726,10858
1506609,SANTA MARIA DO PARÁ,PA,0.565,0.435,8299,6395,14694
1500859,ANAPU,PA,0.465,0.535,5203,5979,11182
1500305,AFUÁ,PA,0.663,0.337,11169,5684,16853
1500909,AUGUSTO CORRÊA,PA,0.751,0.249,17073,5673,22746
1503200,IGARAPÉ-AÇU,PA,0.726,0.274,14992,5649,20641
1506005,PRAINHA,PA,0.635,0.365,9806,5641,15447
1506195,RURÓPOLIS,PA,0.498,0.502,5511,5564,11075
1507458,SÃO GERALDO DO ARAGUAIA,PA,0.532,0.468,6276,5519,11795
1502772,CURIONÓPOLIS,PA,0.49,0.51,5195,5406,10601
1505809,PORTEL,PA,0.707,0.293,13016,5388,18404
1502756,CONCÓRDIA DO PARÁ,PA,0.65,0.35,9628,5179,14807
1506351,SANTA BÁRBARA DO PARÁ,PA,0.587,0.413,7364,5175,12539
1504307,MARACANÃ,PA,0.699,0.301,12021,5165,17186
1502905,CURUÇÁ,PA,0.755,0.245,15550,5033,20583
1507003,SANTO ANTÔNIO DO TAUÁ,PA,0.689,0.311,11076,5010,16086
1506161,RIO MARIA,PA,0.436,0.564,3877,5007,8884
1504406,MARAPANIM,PA,0.672,0.328,10105,4943,15048
1502954,ELDORADO DO CARAJÁS,PA,0.577,0.423,6733,4937,11670
1501451,BELTERRA,PA,0.541,0.459,5497,4663,10160
1503093,GOIANÉSIA DO PARÁ,PA,0.639,0.361,8242,4648,12890
1508126,ULIANÓPOLIS,PA,0.578,0.422,6348,4642,10990
1508308,VISEU,PA,0.831,0.169,21955,4476,26431
1506583,SANTA MARIA DAS BARREIRAS,PA,0.435,0.565,3411,4427,7838
1503044,FLORESTA DO ARAGUAIA,PA,0.524,0.476,4799,4363,9162
1500701,ANAJÁS,PA,0.618,0.382,6951,4300,11251
1508357,VITÓRIA DO XINGU,PA,0.515,0.485,4540,4272,8812
1501204,BAIÃO,PA,0.751,0.249,12183,4044,16227
1503507,IRITUIA,PA,0.763,0.237,12956,4031,16987
1503457,IPIXUNA DO PARÁ,PA,0.675,0.325,8214,3962,12176
1500503,ALMEIRIM,PA,0.725,0.275,10213,3882,14095
1507201,SÃO DOMINGOS DO CAPIM,PA,0.748,0.252,11473,3872,15345
1504604,MOCAJUBA,PA,0.771,0.229,12928,3847,16775
1508050,TRAIRÃO,PA,0.392,0.608,2456,3815,6271
1505650,PLACAS,PA,0.477,0.523,3478,3809,7287
1507979,TERRA SANTA,PA,0.586,0.414,5303,3753,9056
1507151,SÃO DOMINGOS DO ARAGUAIA,PA,0.618,0.382,5976,3701,9677
1507409,SÃO FRANCISCO DO PARÁ,PA,0.634,0.366,6328,3646,9974
1504950,NOVA ESPERANÇA DO PIRIÁ,PA,0.605,0.395,5574,3639,9213
1505908,PORTO DE MOZ,PA,0.711,0.289,8813,3577,12390
1503077,GARRAFÃO DO NORTE,PA,0.739,0.261,10084,3557,13641
1504901,MUANÁ,PA,0.793,0.207,13130,3433,16563
1501907,BUJARU,PA,0.752,0.248,10347,3404,13751
1504000,LIMOEIRO DO AJURU,PA,0.76,0.24,10679,3381,14060
1500958,AURORA DO PARÁ,PA,0.708,0.292,8146,3357,11503
1507474,SÃO JOÃO DE PIRABAS,PA,0.696,0.304,7397,3227,10624
1504976,NOVA IPIXUNA,PA,0.531,0.469,3645,3221,6866
1507904,SOURE,PA,0.755,0.245,9682,3137,12819
1508035,TRACUATEUA,PA,0.813,0.187,13507,3100,16607
1500347,ÁGUA AZUL DO NORTE,PA,0.472,0.528,2743,3065,5808
1501576,BOM JESUS DO TOCANTINS,PA,0.573,0.427,4105,3058,7163
1505700,PONTA DE PEDRAS,PA,0.785,0.215,10879,2982,13861
1506302,SALVATERRA,PA,0.748,0.252,8757,2955,11712
1507706,SÃO SEBASTIÃO DA BOA VISTA,PA,0.786,0.214,10358,2813,13171
1505205,OEIRAS DO PARÁ,PA,0.809,0.191,11875,2804,14679
1503101,GURUPÁ,PA,0.775,0.225,9551,2771,12322
1506559,SANTA LUZIA DO PARÁ,PA,0.74,0.26,7632,2684,10316
1505403,OURÉM,PA,0.741,0.259,7541,2637,10178
1505635,PIÇARRA,PA,0.512,0.488,2749,2621,5370
1507102,SÃO CAETANO DE ODIVELAS,PA,0.726,0.274,6784,2556,9340
1507508,SÃO JOÃO DO ARAGUAIA,PA,0.648,0.352,4372,2376,6748
1503408,INHANGAPI,PA,0.629,0.371,4020,2369,6389
1507805,SENADOR JOSÉ PORFÍRIO,PA,0.663,0.337,4577,2329,6906
1507961,TERRA ALTA,PA,0.678,0.322,4726,2241,6967
1502806,CURRALINHO,PA,0.843,0.157,11165,2076,13241
1505007,NOVA TIMBOTEUA,PA,0.729,0.271,5548,2064,7612
1505551,PAU D'ARCO,PA,0.502,0.498,2046,2033,4079
1506104,PRIMAVERA,PA,0.702,0.298,4731,2010,6741
1504505,MELGAÇO,PA,0.756,0.244,6115,1970,8085
1502509,CHAVES,PA,0.765,0.235,6408,1968,8376
1501006,AVEIRO,PA,0.675,0.325,4000,1926,5926
1502004,CACHOEIRA DO ARARI,PA,0.826,0.174,9055,1908,10963
1505601,PEIXE-BOI,PA,0.678,0.322,3890,1851,5741
1501600,BONITO,PA,0.776,0.224,6275,1816,8091
1502764,CUMARU DO NORTE,PA,0.521,0.479,1878,1724,3602
1501956,CACHOEIRA DO PIRIÁ,PA,0.79,0.21,6460,1720,8180
1501758,BREJO GRANDE DO ARAGUAIA,PA,0.628,0.372,2700,1602,4302
1506112,QUATIPURU,PA,0.741,0.259,4447,1553,6000
1504109,MAGALHÃES BARATA,PA,0.697,0.303,3562,1552,5114
1505494,PALESTINA DO PARÁ,PA,0.616,0.384,2385,1485,3870
1502855,CURUÁ,PA,0.792,0.208,5629,1482,7111
1502608,COLARES,PA,0.767,0.233,4871,1480,6351
1501105,BAGRE,PA,0.816,0.184,6342,1430,7772
1503754,JACAREACANGA,PA,0.755,0.245,4370,1419,5789
1500131,ABEL FIGUEIREDO,PA,0.645,0.355,2491,1371,3862
1507755,SAPUCAIA,PA,0.543,0.457,1555,1310,2865
1507466,SÃO JOÃO DA PONTA,PA,0.717,0.283,2776,1094,3870
1501253,BANNACH,PA,0.415,0.585,744,1050,1794
1506906,SANTARÉM NOVO,PA,0.811,0.189,3570,830,4400
1506401,SANTA CRUZ DO ARARI,PA,0.759,0.241,2590,821,3411
1503002,FARO,PA,0.836,0.164,3216,633,3849
2507507,JOÃO PESSOA,PB,0.452,0.548,188655,228710,417365
2504009,CAMPINA GRANDE,PB,0.437,0.563,98243,126554,224797
2513703,SANTA RITA,PB,0.574,0.426,41667,30877,72544
2501807,BAYEUX,PB,0.522,0.478,29039,26588,55627
2510808,PATOS,PB,0.624,0.376,30556,18444,49000
2503209,CABEDELO,PB,0.491,0.509,17190,17852,35042
2506301,GUARABIRA,PB,0.579,0.421,18078,13123,31201
2516201,SOUSA,PB,0.733,0.267,26445,9621,36066
2513901,SÃO BENTO,PB,0.523,0.477,9207,8399,17606
2515302,SAPÉ,PB,0.702,0.298,19016,8071,27087
2508901,MAMANGUAPE,PB,0.668,0.332,15771,7821,23592
2512507,QUEIMADAS,PB,0.699,0.301,17660,7618,25278
2512101,POMBAL,PB,0.621,0.379,11228,6867,18095
2503704,CAJAZEIRAS,PB,0.815,0.185,28571,6491,35062
2506004,ESPERANÇA,PB,0.653,0.347,11949,6337,18286
2508307,LAGOA SECA,PB,0.589,0.411,8695,6066,14761
2511202,PEDRAS DE FOGO,PB,0.682,0.318,11563,5380,16943
2504603,CONDE,PB,0.648,0.352,9809,5332,15141
2500601,ALHANDRA,PB,0.637,0.363,8538,4863,13401
2506905,ITABAIANA,PB,0.666,0.334,9443,4741,14184
2516003,SOLÂNEA,PB,0.721,0.279,10862,4193,15055
2509701,MONTEIRO,PB,0.777,0.223,14518,4171,18689
2500304,ALAGOA GRANDE,PB,0.736,0.264,11443,4100,15543
2512903,RIO TINTO,PB,0.712,0.288,9885,3990,13875
2504306,CATOLÉ DO ROCHA,PB,0.754,0.246,12017,3914,15931
2503001,CAAPORÃ,PB,0.705,0.295,8616,3602,12218
2512002,POCINHOS,PB,0.65,0.35,6501,3508,10009
2502508,BOQUEIRÃO,PB,0.691,0.309,7376,3292,10668
2509107,MARI,PB,0.752,0.248,9515,3138,12653
2506806,INGÁ,PB,0.708,0.292,7461,3076,10537
2512408,PUXINANÃ,PB,0.658,0.342,5761,2990,8751
2501906,BELÉM,PB,0.701,0.299,6815,2904,9719
2500403,ALAGOA NOVA,PB,0.736,0.264,8098,2899,10997
2504900,CRUZ DO ESPÍRITO SANTO,PB,0.756,0.244,8871,2859,11730
2501104,AREIA,PB,0.79,0.21,10765,2853,13618
2508604,LUCENA,PB,0.659,0.341,5393,2785,8178
2507002,ITAPORANGA,PB,0.783,0.217,9593,2666,12259
2501005,ARARUNA,PB,0.712,0.288,6334,2556,8890
2513406,SANTA LUZIA,PB,0.695,0.305,5736,2518,8254
2511400,PICUÍ,PB,0.767,0.233,8274,2509,10783
2507101,ITAPOROROCA,PB,0.735,0.265,6939,2508,9447
2501500,BANANEIRAS,PB,0.804,0.196,10207,2492,12699
2507309,JACARAÚ,PB,0.736,0.264,6741,2413,9154
2511905,PITIMBU,PB,0.721,0.279,6165,2382,8547
2512705,REMÍGIO,PB,0.773,0.227,7943,2336,10279
2505105,CUITÉ,PB,0.807,0.193,9750,2333,12083
2509206,MASSARANDUBA,PB,0.732,0.268,6137,2248,8385
2509404,MOGEIRO,PB,0.725,0.275,5917,2248,8165
2501302,AROEIRAS,PB,0.806,0.194,9307,2237,11544
2516102,SOLEDADE,PB,0.718,0.282,5688,2235,7923
2507705,JUAZEIRINHO,PB,0.761,0.239,6985,2194,9179
2515104,SÃO SEBASTIÃO DE LAGOA DE ROÇA,PB,0.654,0.346,4123,2181,6304
2511301,PIANCÓ,PB,0.754,0.246,6632,2165,8797
2503506,CACIMBA DE DENTRO,PB,0.781,0.219,7457,2089,9546
2507903,JURIPIRANGA,PB,0.73,0.27,5309,1964,7273
2510907,PAULISTA,PB,0.719,0.281,5014,1959,6973
2515500,SERRA BRANCA,PB,0.733,0.267,5352,1948,7300
2504405,CONCEIÇÃO,PB,0.814,0.186,8410,1921,10331
2502805,BREJO DO CRUZ,PB,0.723,0.277,4926,1889,6815
2516300,SUMÉ,PB,0.806,0.194,7865,1888,9753
2506400,GURINHÉM,PB,0.777,0.223,6441,1845,8286
2513109,SALGADO DE SÃO FÉLIX,PB,0.735,0.265,5114,1842,6956
2511509,PILAR,PB,0.758,0.242,5638,1801,7439
2512309,PRINCESA ISABEL,PB,0.847,0.153,9595,1730,11325
2514503,SÃO JOSÉ DE PIRANHAS,PB,0.852,0.148,9378,1629,11007
2500700,SÃO JOÃO DO RIO DO PEIXE,PB,0.848,0.152,9039,1618,10657
2504801,COREMAS,PB,0.811,0.189,6887,1608,8495
2516706,TEIXEIRA,PB,0.804,0.196,6572,1602,8174
2500809,ARAÇAGI,PB,0.838,0.162,8256,1597,9853
2515971,SOBRADO,PB,0.702,0.298,3636,1546,5182
2507200,ITATUBA,PB,0.753,0.247,4710,1542,6252
2516508,TAPEROÁ,PB,0.8,0.2,6084,1525,7609
2500502,ALAGOINHA,PB,0.816,0.184,6687,1511,8198
2509800,MULUNGU,PB,0.769,0.231,4977,1497,6474
2502151,BOA VISTA,PB,0.667,0.333,2960,1477,4437
2511806,PIRPIRITUBA,PB,0.734,0.266,3961,1434,5395
2516904,UIRAÚNA,PB,0.833,0.167,7008,1408,8416
2500908,ARARA,PB,0.777,0.223,4904,1404,6308
2515005,SÃO MIGUEL DE TAIPU,PB,0.685,0.315,3012,1385,4397
2501575,BARRA DE SANTANA,PB,0.747,0.253,4060,1377,5437
2509305,MATARACA,PB,0.745,0.255,3979,1364,5343
2506103,FAGUNDES,PB,0.812,0.188,5834,1350,7184
2514909,SÃO MAMEDE,PB,0.707,0.293,3190,1320,4510
2501203,AREIAL,PB,0.69,0.31,2920,1312,4232
2501609,BARRA DE SANTA ROSA,PB,0.834,0.166,6565,1304,7869
2510105,NOVA FLORESTA,PB,0.774,0.226,4443,1298,5741
2503605,CAIÇARA,PB,0.693,0.307,2911,1291,4202
2505006,CUBATI,PB,0.736,0.264,3384,1216,4600
2500536,ALCANTIL,PB,0.629,0.371,2052,1212,3264
2502409,BONITO DE SANTA FÉ,PB,0.779,0.221,4273,1209,5482
2515401,SÃO VICENTE DO SERIDÓ,PB,0.824,0.176,5183,1110,6293
2500775,APARECIDA,PB,0.787,0.213,4051,1095,5146
2507606,JUAREZ TÁVORA,PB,0.789,0.211,4059,1088,5147
2503100,CABACEIRAS,PB,0.678,0.322,2284,1083,3367
2504033,CAPIM,PB,0.745,0.255,3131,1074,4205
2516409,TACIMA,PB,0.788,0.212,3939,1062,5001
2515807,SERRA REDONDA,PB,0.779,0.221,3728,1060,4788
2509909,NATUBA,PB,0.764,0.236,3356,1036,4392
2513802,SANTA TERESINHA,PB,0.731,0.269,2727,1005,3732
2502904,BREJO DOS SANTOS,PB,0.763,0.237,3193,993,4186
2513158,SANTA CECÍLIA,PB,0.789,0.211,3679,981,4660
2508208,LAGOA DE DENTRO,PB,0.788,0.212,3617,975,4592
2517001,UMBUZEIRO,PB,0.805,0.195,3934,951,4885
2502003,BELÉM DO BREJO DO CRUZ,PB,0.757,0.243,2964,949,3913
2511103,PEDRA LAVRADA,PB,0.788,0.212,3505,941,4446
2505709,DONA INÊS,PB,0.85,0.15,5288,936,6224
2505204,CUITEGI,PB,0.772,0.228,3160,933,4093
2509156,MARIZÓPOLIS,PB,0.786,0.214,3377,917,4294
2513604,SANTANA DOS GARROTES,PB,0.786,0.214,3295,897,4192
2509503,MONTADAS,PB,0.739,0.261,2541,896,3437
2503803,CALDAS BRANDÃO,PB,0.771,0.229,2976,886,3862
2512721,PEDRO RÉGIS,PB,0.718,0.282,2254,885,3139
2511608,PILÕES,PB,0.814,0.186,3884,885,4769
2516607,TAVARES,PB,0.891,0.109,7133,877,8010
2506251,GADO BRAVO,PB,0.839,0.161,4562,875,5437
2514453,SÃO JOSÉ DOS RAMOS,PB,0.763,0.237,2810,873,3683
2505238,CUITÉ DE MAMANGUAPE,PB,0.821,0.179,3965,863,4828
2512762,RIACHÃO DO POÇO,PB,0.728,0.272,2309,862,3171
2512804,RIACHO DOS CAVALOS,PB,0.852,0.148,4952,860,5812
2507804,JUNCO DO SERIDÓ,PB,0.775,0.225,2927,849,3776
2505402,DESTERRO,PB,0.83,0.17,4151,848,4999
2501708,BARRA DE SÃO MIGUEL,PB,0.779,0.221,2964,843,3807
2504355,CATURITÉ,PB,0.768,0.232,2792,843,3635
2510402,OLHO D'ÁGUA,PB,0.816,0.184,3725,842,4567
2508554,LOGRADOURO,PB,0.67,0.33,1692,833,2525
2504207,CATINGUEIRA,PB,0.736,0.264,2311,829,3140
2512200,PRATA,PB,0.709,0.291,1967,808,2775
2501401,BAÍA DA TRAIÇÃO,PB,0.843,0.157,4237,790,5027
2502607,IGARACY,PB,0.792,0.208,2967,780,3747
2515930,SERTÃOZINHO,PB,0.753,0.247,2369,775,3144
2506707,IMACULADA,PB,0.88,0.12,5443,743,6186
2514602,SÃO JOSÉ DO BONFIM,PB,0.726,0.274,1950,736,2686
2514701,SÃO JOSÉ DO SABUGI,PB,0.757,0.243,2275,731,3006
2508505,LIVRAMENTO,PB,0.821,0.179,3359,731,4090
2504504,CONDADO,PB,0.824,0.176,3317,710,4027
2511707,PILÕEZINHOS,PB,0.812,0.188,3043,703,3746
2514404,SÃO JOSÉ DE ESPINHARAS,PB,0.777,0.223,2406,690,3096
2515906,SERRARIA,PB,0.78,0.22,2420,684,3104
2508000,JURU,PB,0.876,0.124,4817,679,5496
2510501,OLIVEDOS,PB,0.75,0.25,2032,677,2709
2505279,CURRAL DE CIMA,PB,0.812,0.188,2927,676,3603
2502706,BORBOREMA,PB,0.788,0.212,2476,665,3141
2504157,CASSERENGUE,PB,0.84,0.16,3493,664,4157
2503308,CACHOEIRA DOS ÍNDIOS,PB,0.884,0.116,5011,655,5666
2514206,SÃO JOSÉ DA LAGOA TAPADA,PB,0.863,0.137,4112,655,4767
2507408,JERICÓ,PB,0.867,0.133,4153,636,4789
2509339,MATINHAS,PB,0.794,0.206,2405,624,3029
2512754,RIACHÃO DO BACAMARTE,PB,0.798,0.202,2432,616,3048
2504702,CONGO,PB,0.834,0.166,3086,613,3699
2513984,SÃO FRANCISCO,PB,0.79,0.21,2286,608,2894
2509396,MATURÉIA,PB,0.842,0.158,3222,605,3827
2508802,MALTA,PB,0.833,0.167,3017,604,3621
2505600,DIAMANTE,PB,0.84,0.16,3149,602,3751
2513943,SÃO DOMINGOS DO CARIRI,PB,0.687,0.313,1314,600,1914
2505808,DUAS ESTRADAS,PB,0.758,0.242,1875,597,2472
2502102,BOA VENTURA,PB,0.831,0.169,2936,596,3532
2513208,SANTA CRUZ,PB,0.859,0.141,3591,590,4181
2509057,MARCAÇÃO,PB,0.879,0.121,4286,589,4875
2514008,SÃO JOÃO DO CARIRI,PB,0.806,0.194,2395,577,2972
2511004,PEDRA BRANCA,PB,0.782,0.218,2059,575,2634
2500106,ÁGUA BRANCA,PB,0.899,0.101,5080,573,5653
2504074,CARAÚBAS,PB,0.818,0.182,2521,560,3081
2516805,TRIUNFO,PB,0.891,0.109,4507,551,5058
2512747,RIACHÃO,PB,0.757,0.243,1717,550,2267
2517209,VIEIRÓPOLIS,PB,0.847,0.153,3039,549,3588
2509008,MANAÍRA,PB,0.91,0.09,5481,539,6020
2515609,SERRA DA RAIZ,PB,0.709,0.291,1308,537,1845
2506608,IBIARA,PB,0.868,0.132,3266,496,3762
2506202,FREI MARTINHO,PB,0.744,0.256,1435,495,1930
2512606,QUIXABA,PB,0.688,0.312,1054,478,1532
2500205,AGUIAR,PB,0.857,0.143,2827,473,3300
2513968,SÃO DOMINGOS,PB,0.778,0.222,1649,471,2120
2505352,DAMIÃO,PB,0.85,0.15,2678,471,3149
2513927,SÃO BENTINHO,PB,0.817,0.183,2095,469,2564
2501351,ASSUNÇÃO,PB,0.82,0.18,2123,467,2590
2510006,NAZAREZINHO,PB,0.904,0.096,4395,467,4862
2503407,CACIMBA DE AREIA,PB,0.828,0.172,2229,464,2693
2508703,MÃE D'ÁGUA,PB,0.829,0.171,2234,462,2696
2512788,RIACHO DE SANTO ANTÔNIO,PB,0.721,0.279,1187,460,1647
2512077,POÇO DE JOSÉ DE MOURA,PB,0.845,0.155,2496,457,2953
2514107,SÃO JOÃO DO TIGRE,PB,0.837,0.163,2283,443,2726
2501534,BARAÚNA,PB,0.855,0.145,2588,440,3028
2510204,NOVA OLINDA,PB,0.874,0.126,3041,437,3478
2514305,SÃO JOSÉ DE CAIANA,PB,0.871,0.129,2865,425,3290
2505501,VISTA SERRANA,PB,0.778,0.222,1475,421,1896
2503555,CACIMBAS,PB,0.898,0.102,3665,416,4081
2505907,EMAS,PB,0.802,0.198,1678,415,2093
2513307,SANTA HELENA,PB,0.901,0.099,3716,408,4124
2503753,CAJAZEIRINHAS,PB,0.841,0.159,2151,408,2559
2508109,LAGOA,PB,0.877,0.123,2812,394,3206
2510303,NOVA PALMEIRA,PB,0.844,0.156,2116,392,2508
2510600,OURO VELHO,PB,0.812,0.188,1697,392,2089
2510709,PASSAGEM,PB,0.774,0.226,1334,389,1723
2513000,SALGADINHO,PB,0.807,0.193,1624,388,2012
2513851,SANTO ANDRÉ,PB,0.799,0.201,1504,379,1883
2514800,SÃO JOSÉ DOS CORDEIROS,PB,0.842,0.158,2009,376,2385
2506509,GURJÃO,PB,0.84,0.16,1895,362,2257
2517100,VÁRZEA,PB,0.82,0.18,1577,346,1923
2514651,SÃO JOSÉ DO BREJO DO CRUZ,PB,0.751,0.249,1024,340,1364
2509602,MONTE HOREBE,PB,0.878,0.122,2429,338,2767
2515203,SÃO SEBASTIÃO DO UMBUZEIRO,PB,0.86,0.14,2032,332,2364
2516151,SOSSÊGO,PB,0.863,0.137,1996,316,2312
2502300,BOM SUCESSO,PB,0.906,0.094,2953,307,3260
2505303,CURRAL VELHO,PB,0.809,0.191,1295,305,1600
2510659,PARARI,PB,0.801,0.199,1215,302,1517
2508406,LASTRO,PB,0.891,0.109,2430,298,2728
2503902,CAMALAÚ,PB,0.93,0.07,3939,297,4236
2513505,SANTANA DE MANGUEIRA,PB,0.907,0.093,2831,290,3121
2515708,SERRA GRANDE,PB,0.87,0.13,1912,286,2198
2500577,ALGODÃO DE JANDAÍRA,PB,0.874,0.126,1944,280,2224
2502052,BERNARDINO BATISTA,PB,0.872,0.128,1797,263,2060
2512036,POÇO DANTAS,PB,0.899,0.101,2327,260,2587
2504850,COXIXOLA,PB,0.81,0.19,1107,259,1366
2516755,TENÓRIO,PB,0.869,0.131,1717,258,1975
2513653,JOCA CLAUDINO,PB,0.869,0.131,1710,257,1967
2517407,ZABELÊ,PB,0.839,0.161,1285,247,1532
2513356,SANTA INÊS,PB,0.923,0.077,2265,190,2455
2514552,SÃO JOSÉ DE PRINCESA,PB,0.919,0.081,2166,190,2356
2502201,BOM JESUS,PB,0.914,0.086,1999,189,2188
2501153,AREIA DE BARAÚNAS,PB,0.874,0.126,1262,182,1444
2500734,AMPARO,PB,0.902,0.098,1630,177,1807
2509370,MATO GROSSO,PB,0.919,0.081,1633,143,1776
2504108,CARRAPATEIRA,PB,0.906,0.094,1305,136,1441
4106902,CURITIBA,PR,0.235,0.765,241015,786377,1027392
4113700,LONDRINA,PR,0.196,0.804,56111,230473,286584
4115200,MARINGÁ,PR,0.242,0.758,50271,157818,208089
4119905,PONTA GROSSA,PR,0.263,0.737,49049,137776,186825
4104808,CASCAVEL,PR,0.304,0.696,52446,119866,172312
4125506,SÃO JOSÉ DOS PINHAIS,PR,0.243,0.757,35813,111865,147678
4108304,FOZ DO IGUAÇU,PR,0.297,0.703,42061,99545,141606
4105805,COLOMBO,PR,0.294,0.706,32853,78718,111571
4118204,PARANAGUÁ,PR,0.242,0.758,19052,59529,78581
4109401,GUARAPUAVA,PR,0.427,0.573,42173,56654,98827
4127700,TOLEDO,PR,0.276,0.724,21097,55323,76420
4101408,APUCARANA,PR,0.224,0.776,15607,54081,69688
4101507,ARAPONGAS,PR,0.166,0.834,10333,51988,62321
4119152,PINHAIS,PR,0.267,0.733,17893,49224,67117
4104204,CAMPO LARGO,PR,0.266,0.734,17806,49168,66974
4101804,ARAUCÁRIA,PR,0.348,0.652,25283,47434,72717
4128104,UMUARAMA,PR,0.236,0.764,14381,46489,60870
4103701,CAMBÉ,PR,0.234,0.766,12795,41798,54593
4107652,FAZENDA RIO GRANDE,PR,0.314,0.686,16536,36168,52704
4100400,ALMIRANTE TAMANDARÉ,PR,0.326,0.674,17171,35436,52607
4118402,PARANAVAÍ,PR,0.27,0.73,12793,34585,47378
4104303,CAMPO MOURÃO,PR,0.324,0.676,16510,34383,50893
4105508,CIANORTE,PR,0.21,0.79,9029,34002,43031
4119509,PIRAQUARA,PR,0.34,0.66,16251,31538,47789
4118501,PATO BRANCO,PR,0.352,0.648,16395,30191,46586
4126256,SARANDI,PR,0.377,0.623,17398,28697,46095
4122404,ROLÂNDIA,PR,0.219,0.781,8017,28551,36568
4108403,FRANCISCO BELTRÃO,PR,0.438,0.562,21869,28034,49903
4104907,CASTRO,PR,0.326,0.674,13169,27181,40350
4127106,TELÊMACO BORBA,PR,0.304,0.696,11740,26848,38588
4114609,MARECHAL CÂNDIDO RONDON,PR,0.223,0.777,6664,23281,29945
4110706,IRATI,PR,0.347,0.653,12333,23159,35492
4120606,PRUDENTÓPOLIS,PR,0.267,0.733,7999,21933,29932
4109807,IBIPORÃ,PR,0.245,0.755,7070,21838,28908
4128203,UNIÃO DA VITÓRIA,PR,0.307,0.693,9105,20508,29613
4106407,CORNÉLIO PROCÓPIO,PR,0.278,0.722,7513,19513,27026
4115804,MEDIANEIRA,PR,0.292,0.708,7803,18930,26733
4113205,LAPA,PR,0.319,0.681,8862,18887,27749
4124103,SANTO ANTÔNIO DA PLATINA,PR,0.302,0.698,7285,16873,24158
4104006,CAMPINA GRANDE DO SUL,PR,0.312,0.688,7447,16458,23905
4114807,MARIALVA,PR,0.262,0.738,5542,15615,21157
4114203,MANDAGUARI,PR,0.268,0.732,5537,15126,20663
4125605,SÃO MATEUS DO SUL,PR,0.417,0.583,10658,14918,25576
4117701,PALMEIRA,PR,0.271,0.729,5546,14898,20444
4102406,BANDEIRANTES,PR,0.24,0.76,4626,14638,19264
4112009,JAGUARIAÍVA,PR,0.259,0.741,5092,14567,19659
4122305,RIO NEGRO,PR,0.205,0.795,3757,14557,18314
4117909,PALOTINA,PR,0.229,0.771,4204,14145,18349
4109609,GUARATUBA,PR,0.243,0.757,4476,13921,18397
4102000,ASSIS CHATEAUBRIAND,PR,0.328,0.672,6424,13142,19566
4111803,JACAREZINHO,PR,0.421,0.579,9519,13102,22621
4115705,MATINHOS,PR,0.319,0.681,6124,13045,19169
4117503,PAIÇANDU,PR,0.361,0.639,7320,12934,20254
4107207,DOIS VIZINHOS,PR,0.47,0.53,10951,12353,23304
4108809,GUAÍRA,PR,0.285,0.715,4847,12156,17003
4102109,ASTORGA,PR,0.226,0.774,3446,11831,15277
4110102,IMBITUVA,PR,0.36,0.64,6511,11576,18087
4111506,IVAIPORÃ,PR,0.375,0.625,6656,11074,17730
4117602,PALMAS,PR,0.538,0.462,12589,10803,23392
4108601,GOIOERÊ,PR,0.316,0.684,4990,10777,15767
4109708,IBAITI,PR,0.318,0.682,4979,10688,15667
4101606,ARAPOTI,PR,0.258,0.742,3693,10621,14314
4122206,RIO BRANCO DO SUL,PR,0.478,0.522,9451,10317,19768
4120903,QUEDAS DO IGUAÇU,PR,0.378,0.622,6250,10306,16556
4125704,SÃO MIGUEL DO IGUAÇU,PR,0.363,0.637,5832,10243,16075
4116901,NOVA ESPERANÇA,PR,0.303,0.697,4455,10236,14691
4124053,SANTA TEREZINHA DE ITAIPU,PR,0.251,0.749,3378,10067,13445
4104659,CARAMBEÍ,PR,0.241,0.759,3056,9634,12690
4112108,JANDAIA DO SUL,PR,0.242,0.758,3041,9550,12591
4103602,CAMBARÁ,PR,0.296,0.704,4007,9536,13543
4119400,PIRAÍ DO SUL,PR,0.339,0.661,4827,9417,14244
4128005,UBIRATÃ,PR,0.324,0.676,4473,9343,13816
4104253,CAMPO MAGRO,PR,0.357,0.643,5182,9319,14501
4123501,SANTA HELENA,PR,0.394,0.606,6053,9295,15348
4120804,QUATRO BARRAS,PR,0.239,0.761,2824,9011,11835
4119608,PITANGA,PR,0.536,0.464,10180,8811,18991
4119954,PONTAL DO PARANÁ,PR,0.32,0.68,4057,8638,12695
4114104,MANDAGUAÇU,PR,0.32,0.68,4043,8585,12628
4114302,MANDIRITUBA,PR,0.377,0.623,5156,8514,13670
4113304,LARANJEIRAS DO SUL,PR,0.554,0.446,10413,8374,18787
4106605,CRUZEIRO DO OESTE,PR,0.317,0.683,3852,8283,12135
4121703,RESERVA,PR,0.458,0.542,6896,8161,15057
4100509,ALTÔNIA,PR,0.289,0.711,3301,8130,11431
4101101,ANDIRÁ,PR,0.343,0.657,4168,7969,12137
4128500,WENCESLAU BRAZ,PR,0.273,0.727,2959,7898,10857
4115606,MATELÂNDIA,PR,0.2,0.8,1955,7803,9758
4113502,LOANDA,PR,0.325,0.675,3756,7792,11548
4126504,SERTANÓPOLIS,PR,0.221,0.779,2210,7786,9996
4101200,ANTONINA,PR,0.289,0.711,3150,7761,10911
4127403,TERRA ROXA,PR,0.268,0.732,2784,7616,10400
4121208,QUITANDINHA,PR,0.285,0.715,3015,7565,10580
4127205,TERRA BOA,PR,0.25,0.75,2433,7304,9737
4105904,COLORADO,PR,0.437,0.563,5633,7261,12894
4106308,CORBÉLIA,PR,0.314,0.686,3322,7252,10574
4106506,CORONEL VIVIDA,PR,0.477,0.523,6499,7127,13626
4101903,ASSAÍ,PR,0.251,0.749,2373,7092,9465
4126603,SIQUEIRA CAMPOS,PR,0.388,0.612,4439,7000,11439
4119301,PINHÃO,PR,0.604,0.396,10627,6972,17599
4105409,CHOPINZINHO,PR,0.448,0.552,5633,6945,12578
4126306,SENGÉS,PR,0.336,0.664,3444,6812,10256
4103453,CAFELÂNDIA,PR,0.3,0.7,2793,6528,9321
4106209,CONTENDA,PR,0.335,0.665,3270,6493,9763
4116208,MORRETES,PR,0.333,0.667,3210,6441,9651
4107603,FAXINAL,PR,0.276,0.724,2448,6431,8879
4106803,CRUZ MACHADO,PR,0.409,0.591,4364,6305,10669
4119103,PIÊN,PR,0.211,0.789,1659,6212,7871
4102802,BELA VISTA DO PARAÍSO,PR,0.339,0.661,3170,6183,9353
4110607,IPORÃ,PR,0.31,0.69,2771,6173,8944
4121406,REALEZA,PR,0.409,0.591,4252,6135,10387
4111258,ITAPERUÇU,PR,0.604,0.396,9341,6114,15455
4102307,BALSA NOVA,PR,0.301,0.699,2615,6070,8685
4110508,IPIRANGA,PR,0.31,0.69,2713,6044,8757
4127304,TERRA RICA,PR,0.322,0.678,2839,5989,8828
4104709,CARLÓPOLIS,PR,0.304,0.696,2595,5949,8544
4126801,TAPEJARA,PR,0.311,0.689,2642,5866,8508
4114005,MAMBORÊ,PR,0.317,0.683,2713,5836,8549
4127502,TIBAGI,PR,0.467,0.533,5041,5755,10796
4104501,CAPANEMA,PR,0.494,0.506,5601,5744,11345
4122008,RIO AZUL,PR,0.349,0.651,3033,5650,8683
4117305,ORTIGUEIRA,PR,0.584,0.416,7725,5510,13235
4111902,JAGUAPITÃ,PR,0.286,0.714,2194,5490,7684
4113908,MALLET,PR,0.329,0.671,2659,5435,8094
4103909,CAMPINA DA LAGOA,PR,0.389,0.611,3428,5390,8818
4114500,MANOEL RIBAS,PR,0.343,0.657,2803,5362,8165
4109302,GUARANIAÇU,PR,0.381,0.619,3245,5261,8506
4124400,SANTO ANTÔNIO DO SUDOESTE,PR,0.535,0.465,6045,5256,11301
4111407,IVAÍ,PR,0.38,0.62,3207,5237,8444
4105300,CÉU AZUL,PR,0.224,0.776,1497,5178,6675
4101705,ARARUNA,PR,0.349,0.651,2773,5162,7935
4127601,TIJUCAS DO SUL,PR,0.408,0.592,3534,5129,8663
4107504,ENGENHEIRO BELTRÃO,PR,0.342,0.658,2622,5050,7672
4121505,REBOUÇAS,PR,0.462,0.538,4239,4943,9182
4116703,NOVA AURORA,PR,0.339,0.661,2494,4863,7357
4112702,JATAIZINHO,PR,0.336,0.664,2446,4829,7275
4104600,CAPITÃO LEÔNIDAS MARQUES,PR,0.441,0.559,3775,4778,8553
4101002,AMPÉRE,PR,0.555,0.445,5949,4777,10726
4105706,CLEVELÂNDIA,PR,0.509,0.491,4941,4771,9712
4117222,NOVA SANTA ROSA,PR,0.133,0.867,725,4743,5468
4123402,SANTA FÉ,PR,0.301,0.699,2037,4732,6769
4116059,MISSAL,PR,0.333,0.667,2351,4714,7065
4118907,PÉROLA,PR,0.325,0.675,2259,4694,6953
4104402,CÂNDIDO DE ABREU,PR,0.473,0.527,4202,4674,8876
4114401,MANGUEIRINHA,PR,0.548,0.452,5591,4605,10196
4118808,PEABIRU,PR,0.379,0.621,2801,4597,7398
4112801,JOAQUIM TÁVORA,PR,0.312,0.688,2076,4570,6646
4116109,MOREIRA SALES,PR,0.369,0.631,2654,4544,7198
4120507,PRIMEIRO DE MAIO,PR,0.306,0.694,1986,4495,6481
4100608,ALTO PARANÁ,PR,0.394,0.606,2899,4467,7366
4121802,RIBEIRÃO CLARO,PR,0.374,0.626,2641,4418,7059
4107009,CURIÚVA,PR,0.419,0.581,3171,4394,7565
4115408,MARMELEIRO,PR,0.515,0.485,4623,4351,8974
4118006,PARAÍSO DO NORTE,PR,0.387,0.613,2725,4320,7045
4120002,PORECATU,PR,0.42,0.58,3090,4267,7357
4103107,BOCAIÚVA DO SUL,PR,0.377,0.623,2543,4202,6745
4128401,URAÍ,PR,0.356,0.644,2306,4180,6486
4105201,CERRO AZUL,PR,0.559,0.441,5283,4167,9450
4124020,SANTA TEREZA DO OESTE,PR,0.392,0.608,2665,4134,6799
4112405,JAPURÁ,PR,0.254,0.746,1401,4115,5516
4102901,BITURUNA,PR,0.562,0.438,5242,4087,9329
4110953,ITAIPULÂNDIA,PR,0.398,0.602,2696,4070,6766
4105607,CIDADE GAÚCHA,PR,0.377,0.623,2456,4059,6515
4123907,SANTA MARIANA,PR,0.428,0.572,3002,4018,7020
4117107,NOVA LONDRINA,PR,0.402,0.598,2699,4017,6716
4124806,SÃO JOÃO,PR,0.442,0.558,3120,3935,7055
4127858,TRÊS BARRAS DO PARANÁ,PR,0.432,0.568,2958,3889,6847
4122602,RONDON,PR,0.315,0.685,1737,3779,5516
4121901,RIBEIRÃO DO PINHAL,PR,0.513,0.487,3963,3769,7732
4108007,FLORESTÓPOLIS,PR,0.486,0.514,3554,3760,7314
4112504,JARDIM ALEGRE,PR,0.434,0.566,2867,3741,6608
4114906,MARILÂNDIA DO SUL,PR,0.304,0.696,1628,3732,5360
4125100,SÃO JOÃO DO TRIUNFO,PR,0.582,0.418,5174,3714,8888
4102505,BARBOSA FERRAZ,PR,0.416,0.584,2641,3707,6348
4100301,AGUDOS DO SUL,PR,0.324,0.676,1770,3692,5462
4103503,CALIFÓRNIA,PR,0.302,0.698,1584,3655,5239
4127965,TURVO,PR,0.592,0.408,5298,3651,8949
4119806,PLANALTO,PR,0.538,0.462,4230,3636,7866
4123709,SANTA ISABEL DO IVAÍ,PR,0.308,0.692,1616,3633,5249
4125803,SÃO PEDRO DO IVAÍ,PR,0.351,0.649,1960,3630,5590
4122701,SABÁUDIA,PR,0.198,0.802,887,3603,4490
4125001,SÃO JOÃO DO IVAÍ,PR,0.475,0.525,3258,3599,6857
4120705,QUATIGUÁ,PR,0.275,0.725,1361,3583,4944
4127957,TUPÃSSI,PR,0.263,0.737,1269,3559,4828
4109906,ICARAÍMA,PR,0.324,0.676,1692,3531,5223
4104428,CANDÓI,PR,0.598,0.402,5171,3478,8649
4112751,JESUÍTAS,PR,0.36,0.64,1951,3464,5415
4127007,TEIXEIRA SOARES,PR,0.419,0.581,2475,3431,5906
4126678,TAMARANA,PR,0.423,0.577,2499,3403,5902
4115358,MARIPÁ,PR,0.176,0.824,728,3401,4129
4115754,MAUÁ DA SERRA,PR,0.38,0.62,2081,3400,5481
4107256,DOURADINA,PR,0.356,0.644,1875,3394,5269
4117800,PALMITAL,PR,0.582,0.418,4712,3385,8097
4123808,SANTA IZABEL DO OESTE,PR,0.499,0.501,3335,3344,6679
4100806,ALVORADA DO SUL,PR,0.378,0.622,2019,3323,5342
4110078,IMBAÚ,PR,0.461,0.539,2841,3323,6164
4127908,TUNEIRAS DO OESTE,PR,0.352,0.648,1790,3301,5091
4128559,VERA CRUZ DO OESTE,PR,0.352,0.648,1792,3299,5091
4125209,SÃO JORGE D'OESTE,PR,0.475,0.525,2975,3283,6258
4111209,ITAPEJARA D'OESTE,PR,0.54,0.46,3782,3223,7005
4103800,CAMBIRA,PR,0.305,0.695,1390,3169,4559
4115101,MARILUZ,PR,0.464,0.536,2741,3164,5905
4107900,FLORESTA,PR,0.292,0.708,1307,3163,4470
4108205,FORMOSA DO OESTE,PR,0.313,0.687,1431,3139,4570
4115853,MERCEDES,PR,0.168,0.832,629,3119,3748
4123006,SALTO DO LONTRA,PR,0.638,0.362,5482,3112,8594
4127809,TOMAZINA,PR,0.361,0.639,1745,3090,4835
4112959,JURANDA,PR,0.339,0.661,1579,3072,4651
4108957,GUAMIRANGA,PR,0.415,0.585,2166,3051,5217
4102604,BARRACÃO,PR,0.453,0.547,2520,3045,5565
4104105,CAMPO DO TENENTE,PR,0.348,0.652,1619,3031,4650
4117255,NOVA PRATA DO IGUAÇU,PR,0.55,0.45,3678,3014,6692
4108502,GENERAL CARNEIRO,PR,0.545,0.455,3604,3007,6611
4103305,BORRAZÓPOLIS,PR,0.373,0.627,1776,2981,4757
4108320,FRANCISCO ALVES,PR,0.335,0.665,1473,2920,4393
4105003,CATANDUVAS,PR,0.414,0.586,2062,2918,4980
4118105,PARANACITY,PR,0.489,0.511,2788,2917,5705
4122503,RONCADOR,PR,0.565,0.435,3772,2902,6674
4105102,CENTENÁRIO DO SUL,PR,0.559,0.441,3658,2884,6542
4118857,PEROBAL,PR,0.292,0.708,1182,2862,4044
4100707,ALTO PIQUIRI,PR,0.497,0.503,2773,2808,5581
4123303,SANTA CRUZ DE MONTE CASTELO,PR,0.453,0.547,2311,2789,5100
4118709,PAULO FRONTIN,PR,0.373,0.627,1659,2784,4443
4110805,IRETAMA,PR,0.524,0.476,3048,2774,5822
4121000,QUERÊNCIA DO NORTE,PR,0.561,0.439,3526,2754,6280
4100103,ABATIÁ,PR,0.392,0.608,1767,2746,4513
4117008,NOVA FÁTIMA,PR,0.366,0.634,1579,2738,4317
4126009,SÃO SEBASTIÃO DA AMOREIRA,PR,0.478,0.522,2483,2707,5190
4128534,VENTANIA,PR,0.501,0.499,2699,2685,5384
4110201,INÁCIO MARTINS,PR,0.579,0.421,3686,2682,6368
4104451,CANTAGALO,PR,0.606,0.394,4127,2681,6808
4101309,ANTÔNIO OLINTO,PR,0.456,0.544,2237,2672,4909
4118451,PATO BRAGADO,PR,0.213,0.787,724,2672,3396
4128708,VITORINO,PR,0.346,0.654,1406,2660,4066
4124707,SÃO JERÔNIMO DA SERRA,PR,0.566,0.434,3389,2596,5985
4107751,FIGUEIRA,PR,0.468,0.532,2275,2581,4856
4125407,SÃO JOSÉ DA BOA VISTA,PR,0.265,0.735,931,2580,3511
4107306,DOUTOR CAMARGO,PR,0.303,0.697,1118,2575,3693
4125357,SÃO JORGE DO PATROCÍNIO,PR,0.368,0.632,1485,2555,4040
4124608,SÃO CARLOS DO IVAÍ,PR,0.335,0.665,1284,2546,3830
4113007,JUSSARA,PR,0.372,0.628,1501,2535,4036
4120853,QUATRO PONTES,PR,0.139,0.861,404,2509,2913
4111555,IVATÉ,PR,0.416,0.584,1773,2493,4266
4119202,PINHALÃO,PR,0.389,0.611,1575,2479,4054
4111001,ITAMBARACÁ,PR,0.33,0.67,1218,2468,3686
4128807,XAMBRÊ,PR,0.392,0.608,1587,2461,4048
4111100,ITAMBÉ,PR,0.34,0.66,1267,2458,3725
4103057,BOA VISTA DA APARECIDA,PR,0.489,0.511,2348,2453,4801
4126355,SERRANÓPOLIS DO IGUAÇU,PR,0.281,0.719,948,2427,3375
4126108,SÃO TOMÉ,PR,0.3,0.7,1041,2426,3467
4125308,SÃO JORGE DO IVAÍ,PR,0.325,0.675,1160,2409,3569
4126405,SERTANEJA,PR,0.351,0.649,1303,2404,3707
4125753,SÃO PEDRO DO IGUAÇU,PR,0.39,0.61,1533,2398,3931
4108700,GRANDES RIOS,PR,0.328,0.672,1167,2393,3560
4109500,GUARAQUEÇABA,PR,0.485,0.515,2245,2380,4625
4128609,VERÊ,PR,0.56,0.44,3030,2378,5408
4117206,NOVA OLÍMPIA,PR,0.349,0.651,1270,2366,3636
4115309,MARIÓPOLIS,PR,0.432,0.568,1779,2341,4120
4117057,NOVA LARANJEIRAS,PR,0.615,0.385,3741,2340,6081
4117453,OURO VERDE DO OESTE,PR,0.356,0.644,1288,2331,3619
4109203,GUARACI,PR,0.319,0.681,1084,2310,3394
4106001,CONGONHINHAS,PR,0.545,0.455,2730,2281,5011
4108908,GUAIRAÇÁ,PR,0.393,0.607,1470,2267,3737
4107801,FLORAÍ,PR,0.348,0.652,1206,2256,3462
4119004,PÉROLA D'OESTE,PR,0.451,0.549,1851,2250,4101
4103206,BOM SUCESSO,PR,0.437,0.563,1714,2210,3924
4118600,PAULA FREITAS,PR,0.369,0.631,1285,2196,3481
4103008,BOA ESPERANÇA,PR,0.257,0.743,757,2192,2949
4122156,RIO BONITO DO IGUAÇU,PR,0.745,0.255,6412,2190,8602
4120358,PRANCHITA,PR,0.426,0.574,1607,2162,3769
4113734,LUIZIANA,PR,0.497,0.503,2129,2159,4288
4123857,SANTA MARIA DO OESTE,PR,0.633,0.367,3712,2156,5868
4107736,FERNANDES PINHEIRO,PR,0.494,0.506,2056,2104,4160
4111704,JABOTI,PR,0.322,0.678,982,2067,3049
4107538,ENTRE RIOS DO OESTE,PR,0.235,0.765,635,2062,2697
4114708,MARIA HELENA,PR,0.435,0.565,1574,2045,3619
4126900,TAPIRA,PR,0.42,0.58,1463,2017,3480
4122651,ROSÁRIO DO IVAÍ,PR,0.407,0.593,1380,2014,3394
4112207,JANIÓPOLIS,PR,0.469,0.531,1738,1965,3703
4110409,INDIANÓPOLIS,PR,0.315,0.685,903,1963,2866
4120101,PORTO AMAZONAS,PR,0.288,0.712,785,1939,2724
4107108,DIAMANTE DO NORTE,PR,0.391,0.609,1245,1939,3184
4127882,TUNAS DO PARANÁ,PR,0.478,0.522,1765,1931,3696
4126207,SAPOPEMA,PR,0.499,0.501,1901,1906,3807
4126702,TAMBOARA,PR,0.366,0.634,1098,1902,3000
4121604,RENASCENÇA,PR,0.539,0.461,2216,1894,4110
4107546,ESPIGÃO ALTO DO IGUAÇU,PR,0.391,0.609,1209,1886,3095
4115002,MARILENA,PR,0.547,0.453,2268,1877,4145
4110003,IGUARAÇU,PR,0.311,0.689,838,1858,2696
4124004,SANTANA DO ITARARÉ,PR,0.439,0.561,1438,1841,3279
4103479,CAFEZAL DO SUL,PR,0.365,0.635,1057,1841,2898
4113106,KALORÉ,PR,0.351,0.649,995,1838,2833
4116802,NOVA CANTU,PR,0.583,0.417,2565,1831,4396
4103354,BRAGANEY,PR,0.456,0.544,1535,1831,3366
4109757,IBEMA,PR,0.48,0.52,1687,1828,3515
4124509,SANTO INÁCIO,PR,0.477,0.523,1651,1809,3460
4113759,LUNARDELLI,PR,0.438,0.562,1384,1773,3157
4102208,ATALAIA,PR,0.353,0.647,962,1760,2722
4107405,ENÉAS MARQUES,PR,0.574,0.426,2308,1715,4023
4121109,QUINTA DO SOL,PR,0.46,0.54,1431,1681,3112
4112306,JAPIRA,PR,0.399,0.601,1113,1679,2792
4122909,SALTO DO ITARARÉ,PR,0.45,0.55,1369,1671,3040
4113601,LOBATO,PR,0.396,0.604,1095,1668,2763
4115507,MARUMBI,PR,0.434,0.566,1260,1640,2900
4120655,QUARTO CENTENÁRIO,PR,0.412,0.588,1140,1627,2767
4109005,GUAPIRAMA,PR,0.394,0.606,1055,1621,2676
4126272,SAUDADE DO IGUAÇU,PR,0.551,0.449,1972,1605,3577
4116307,MUNHOZ DE MELO,PR,0.379,0.621,974,1599,2573
4117271,NOVA TEBAS,PR,0.639,0.361,2829,1597,4426
4121307,RANCHO ALEGRE,PR,0.34,0.66,809,1572,2381
4120408,PRESIDENTE CASTELO BRANCO,PR,0.463,0.537,1343,1556,2899
4113429,LIDIANÓPOLIS,PR,0.377,0.623,936,1547,2483
4107702,FÊNIX,PR,0.447,0.553,1250,1544,2794
4124905,SÃO JOÃO DO CAIUÁ,PR,0.546,0.454,1850,1540,3390
4128633,DOUTOR ULYSSES,PR,0.543,0.457,1823,1532,3355
4107850,FLOR DA SERRA DO SUL,PR,0.57,0.43,2021,1527,3548
4100905,AMAPORÃ,PR,0.511,0.489,1538,1474,3012
4116950,NOVA ESPERANÇA DO SUDOESTE,PR,0.608,0.392,2290,1474,3764
4113452,LINDOESTE,PR,0.596,0.404,2157,1460,3617
4100202,ADRIANÓPOLIS,PR,0.607,0.393,2251,1456,3707
4103222,BOM SUCESSO DO SUL,PR,0.383,0.617,899,1450,2349
4121752,RESERVA DO IGUAÇU,PR,0.637,0.363,2531,1445,3976
4113403,LEÓPOLIS,PR,0.448,0.552,1171,1441,2612
4106704,CRUZEIRO DO SUL,PR,0.54,0.46,1681,1434,3115
4120309,PORTO VITÓRIA,PR,0.385,0.615,893,1425,2318
4119657,PITANGUEIRAS,PR,0.274,0.726,536,1423,1959
4122107,RIO BOM,PR,0.358,0.642,775,1387,2162
4123824,SANTA LÚCIA,PR,0.432,0.568,1050,1382,2432
4123204,SANTA CECÍLIA DO PAVÃO,PR,0.395,0.605,902,1380,2282
4101150,ÂNGULO,PR,0.296,0.704,578,1378,1956
4117297,NOVO ITACOLOMI,PR,0.331,0.669,673,1359,2032
4123105,SANTA AMÉLIA,PR,0.424,0.576,997,1357,2354
4113809,LUPIONÓPOLIS,PR,0.545,0.455,1621,1353,2974
4122800,SALGADO FILHO,PR,0.526,0.474,1493,1343,2836
4117214,NOVA SANTA BÁRBARA,PR,0.484,0.516,1259,1340,2599
4103040,BOA VENTURA DE SÃO ROQUE,PR,0.653,0.347,2486,1322,3808
4128658,VIRMOND,PR,0.507,0.493,1354,1316,2670
4106100,CONSELHEIRO MAIRINCK,PR,0.4,0.6,866,1298,2164
4106456,CORONEL DOMINGOS SOARES,PR,0.657,0.343,2483,1295,3778
4106852,CRUZMALTINA,PR,0.362,0.638,733,1293,2026
4120333,PRADO FERREIRA,PR,0.462,0.538,1110,1291,2401
4110904,ITAGUAJÉ,PR,0.483,0.517,1205,1291,2496
4125456,SÃO JOSÉ DAS PALMEIRAS,PR,0.495,0.505,1248,1273,2521
4116604,NOVA AMÉRICA DA COLINA,PR,0.451,0.549,1039,1264,2303
4104055,CAMPO BONITO,PR,0.549,0.451,1519,1247,2766
4109658,HONÓRIO SERPA,PR,0.623,0.377,2054,1243,3297
4125902,SÃO PEDRO DO PARANÁ,PR,0.32,0.68,577,1228,1805
4106555,CORUMBATAÍ DO SUL,PR,0.517,0.483,1308,1221,2529
4128625,ALTO PARAÍSO,PR,0.418,0.582,869,1208,2077
4119707,PLANALTINA DO PARANÁ,PR,0.533,0.467,1372,1204,2576
4107553,FAROL,PR,0.451,0.549,967,1176,2143
4100459,ALTAMIRA DO PARANÁ,PR,0.523,0.477,1288,1174,2462
4122172,RIO BRANCO DO IVAÍ,PR,0.491,0.509,1125,1167,2292
4101655,ARAPUÃ,PR,0.536,0.464,1331,1150,2481
4108650,GOIOXIM,PR,0.715,0.285,2867,1145,4012
4106571,CRUZEIRO DO IGUAÇU,PR,0.574,0.426,1537,1142,2679
4121257,RAMILÂNDIA,PR,0.535,0.465,1310,1139,2449
4111605,IVATUBA,PR,0.356,0.644,617,1116,1733
4107157,DIAMANTE D'OESTE,PR,0.598,0.402,1647,1105,2752
4117404,OURIZONA,PR,0.498,0.502,1082,1090,2172
4113254,LARANJAL,PR,0.683,0.317,2343,1087,3430
4101051,ANAHY,PR,0.447,0.553,878,1085,1963
4103370,BRASILÂNDIA DO SUL,PR,0.516,0.484,1155,1085,2240
4103156,BOM JESUS DO SUL,PR,0.61,0.39,1686,1079,2765
4102703,BARRA DO JACARÉ,PR,0.434,0.566,825,1075,1900
4108452,FOZ DO JORDÃO,PR,0.637,0.363,1877,1071,2948
4120200,PORTO RICO,PR,0.396,0.604,702,1071,1773
4121356,RANCHO ALEGRE D'OESTE,PR,0.417,0.583,762,1066,1828
4126652,SULINA,PR,0.522,0.478,1160,1063,2223
4115457,MARQUINHO,PR,0.629,0.371,1802,1062,2864
4116406,NOSSA SENHORA DAS GRAÇAS,PR,0.548,0.452,1248,1030,2278
4125555,SÃO MANOEL DO PARANÁ,PR,0.299,0.701,437,1025,1462
4107520,ESPERANÇA NOVA,PR,0.295,0.705,422,1010,1432
4107124,DIAMANTE DO SUL,PR,0.536,0.464,1165,1008,2173
4108106,FLÓRIDA,PR,0.432,0.568,756,996,1752
4120150,PORTO BARREIRO,PR,0.591,0.409,1412,979,2391
4123956,SANTA MÔNICA,PR,0.519,0.481,1055,977,2032
4112900,JUNDIAÍ DO SUL,PR,0.515,0.485,1021,960,1981
4124301,SANTO ANTÔNIO DO PARAÍSO,PR,0.411,0.589,660,947,1607
4103958,CAMPINA DO SIMÃO,PR,0.647,0.353,1704,929,2633
4110656,IRACEMA DO OESTE,PR,0.463,0.537,796,924,1720
4128302,UNIFLOR,PR,0.459,0.541,757,893,1650
4102752,BELA VISTA DA CAROBA,PR,0.627,0.373,1481,880,2361
4109104,GUAPOREMA,PR,0.37,0.63,505,860,1365
4110300,INAJÁ,PR,0.551,0.449,1027,837,1864
4110052,IGUATU,PR,0.479,0.521,752,818,1570
4108551,GODOY MOREIRA,PR,0.604,0.396,1240,814,2054
4116000,MIRASELVA,PR,0.429,0.571,603,804,1407
4115739,MATO RICO,PR,0.651,0.349,1491,801,2292
4124202,SANTO ANTÔNIO DO CAIUÁ,PR,0.546,0.454,932,776,1708
4111308,ITAÚNA DO SUL,PR,0.622,0.378,1250,760,2010
4118303,PARANAPOEMA,PR,0.555,0.445,909,730,1639
4103404,CAFEARA,PR,0.577,0.423,955,700,1655
4101853,ARIRANHA DO IVAÍ,PR,0.599,0.401,1016,679,1695
4115903,MIRADOR,PR,0.558,0.442,821,650,1471
4114351,MANFRINÓPOLIS,PR,0.693,0.307,1458,647,2105
4123600,SANTA INÊS,PR,0.496,0.504,631,641,1272
4103024,BOA ESPERANÇA DO IGUAÇU,PR,0.678,0.322,1227,584,1811
4116505,NOVA ALIANÇA DO IVAÍ,PR,0.461,0.539,487,570,1057
4119251,PINHAL DE SÃO BENTO,PR,0.705,0.295,1296,541,1837
4112603,JARDIM OLINDA,PR,0.675,0.325,670,323,993
2611606,RECIFE,PE,0.525,0.475,482673,436764,919437
2607901,JABOATÃO DOS GUARARAPES,PE,0.534,0.466,175911,153618,329529
2609600,OLINDA,PE,0.565,0.435,127824,98361,226185
2604106,CARUARU,PE,0.54,0.46,90803,77455,168258
2610707,PAULISTA,PE,0.549,0.451,92381,75856,168237
2611101,PETROLINA,PE,0.68,0.32,105663,49661,155324
2603454,CAMARAGIBE,PE,0.549,0.451,49546,40652,90198
2602902,CABO DE SANTO AGOSTINHO,PE,0.685,0.315,79320,36402,115722
2616407,VITÓRIA DE SANTO ANTÃO,PE,0.576,0.424,42608,31301,73909
2600054,ABREU E LIMA,PE,0.591,0.409,36019,24961,60980
2612505,SANTA CRUZ DO CAPIBARIBE,PE,0.462,0.538,19765,23044,42809
2613701,SÃO LOURENÇO DA MATA,PE,0.624,0.376,36244,21799,58043
2606804,IGARASSU,PE,0.661,0.339,40695,20826,61521
2606002,GARANHUNS,PE,0.722,0.278,49373,18995,68368
2604007,CARPINA,PE,0.571,0.429,23366,17563,40929
2606408,GRAVATÁ,PE,0.656,0.344,29444,15461,44905
2606200,GOIANA,PE,0.666,0.334,29874,14970,44844
2601706,BELO JARDIM,PE,0.687,0.313,27616,12584,40200
2607208,IPOJUCA,PE,0.778,0.222,42163,12034,54197
2614501,SURUBIM,PE,0.671,0.329,22848,11188,34036
2610608,PAUDALHO,PE,0.638,0.362,19505,11089,30594
2609402,MORENO,PE,0.679,0.321,23323,11046,34369
2615409,TORITAMA,PE,0.57,0.43,13038,9830,22868
2613909,SERRA TALHADA,PE,0.773,0.227,33354,9809,43163
2615300,TIMBAÚBA,PE,0.671,0.329,19783,9717,29500
2601201,ARCOVERDE,PE,0.725,0.275,25396,9623,35019
2605202,ESCADA,PE,0.726,0.274,25451,9595,35046
2608909,LIMOEIRO,PE,0.719,0.281,23724,9270,32994
2601904,BEZERROS,PE,0.738,0.262,25082,8900,33982
2610004,PALMARES,PE,0.736,0.264,21163,7599,28762
2602308,BONITO,PE,0.654,0.346,14054,7438,21492
2601102,ARARIPINA,PE,0.827,0.173,33843,7083,40926
2609501,NAZARÉ DA MATA,PE,0.629,0.371,11693,6905,18598
2608800,LAJEDO,PE,0.673,0.327,13750,6678,20428
2602605,BREJO DA MADRE DE DEUS,PE,0.708,0.292,15611,6442,22053
2601409,BARREIROS,PE,0.693,0.307,14345,6368,20713
2614204,SIRINHAÉM,PE,0.683,0.317,13461,6245,19706
2615003,TAQUARITINGA DO NORTE,PE,0.566,0.434,8009,6149,14158
2613008,SÃO BENTO DO UNA,PE,0.76,0.24,18139,5727,23866
2612208,SALGUEIRO,PE,0.815,0.185,25020,5694,30714
2611804,RIBEIRÃO,PE,0.717,0.283,14120,5563,19683
2610905,PESQUEIRA,PE,0.844,0.156,28817,5311,34128
2600708,ALIANÇA,PE,0.744,0.256,14987,5160,20147
2613107,SÃO CAITANO,PE,0.771,0.229,16917,5028,21945
2610202,PANELAS,PE,0.635,0.365,8582,4924,13506
2602209,BOM JARDIM,PE,0.772,0.228,16349,4837,21186
2607653,ITAMBÉ,PE,0.731,0.269,12957,4758,17715
2616308,VICÊNCIA,PE,0.698,0.302,10932,4723,15655
2600104,AFOGADOS DA INGAZEIRA,PE,0.772,0.228,15197,4476,19673
2608503,LAGOA DE ITAENGA,PE,0.647,0.353,8089,4415,12504
2602100,BOM CONSELHO,PE,0.812,0.188,18763,4353,23116
2611309,POMBOS,PE,0.695,0.305,9747,4273,14020
2609006,MACAPARANA,PE,0.677,0.323,8934,4263,13197
2605400,FEIRA NOVA,PE,0.662,0.338,8276,4231,12507
2600500,ÁGUAS BELAS,PE,0.811,0.189,17486,4071,21557
2605004,CUPIRA,PE,0.701,0.299,9441,4019,13460
2604601,CONDADO,PE,0.71,0.29,9638,3940,13578
2610509,PASSIRA,PE,0.779,0.221,13838,3916,17754
2604205,CATENDE,PE,0.771,0.229,13088,3890,16978
2606101,GLÓRIA DO GOITÁ,PE,0.766,0.234,12675,3866,16541
2611705,RIACHO DAS ALMAS,PE,0.73,0.27,10272,3806,14078
2604502,CHÃ GRANDE,PE,0.708,0.292,9075,3750,12825
2607604,ILHA DE ITAMARACÁ,PE,0.712,0.288,9129,3694,12823
2609907,OURICURI,PE,0.888,0.112,29138,3685,32823
2613404,SÃO JOSÉ DA COROA GRANDE,PE,0.62,0.38,5951,3643,9594
2613602,SÃO JOSÉ DO EGITO,PE,0.784,0.216,12970,3576,16546
2614857,TAMANDARÉ,PE,0.7,0.3,8304,3560,11864
2608107,JOÃO ALFREDO,PE,0.781,0.219,12483,3499,15982
2607752,ITAPISSUMA,PE,0.745,0.255,10171,3489,13660
2616209,VERTENTES,PE,0.694,0.306,7795,3442,11237
2611002,PETROLÂNDIA,PE,0.813,0.187,14529,3335,17864
2613305,SÃO JOAQUIM DO MONTE,PE,0.72,0.28,8559,3333,11892
2615607,TRINDADE,PE,0.783,0.217,11966,3316,15282
2603702,CANHOTINHO,PE,0.723,0.277,8183,3133,11316
2608453,LAGOA DO CARRO,PE,0.7,0.3,7198,3078,10276
2600906,AMARAJI,PE,0.734,0.266,8427,3059,11486
2611903,RIO FORMOSO,PE,0.741,0.259,8410,2945,11355
2600302,AGRESTINA,PE,0.792,0.208,11191,2932,14123
2605905,GAMELEIRA,PE,0.727,0.273,7686,2879,10565
2603504,CAMOCIM DE SÃO FÉLIX,PE,0.728,0.272,7656,2867,10523
2601052,ARAÇOIABA,PE,0.757,0.243,8887,2858,11745
2612604,SANTA MARIA DA BOA VISTA,PE,0.862,0.138,17834,2850,20684
2602803,BUÍQUE,PE,0.891,0.109,22579,2775,25354
2603108,CACHOEIRINHA,PE,0.753,0.247,8346,2734,11080
2600401,ÁGUA PRETA,PE,0.805,0.195,11134,2703,13837
2600807,ALTINHO,PE,0.784,0.216,9491,2622,12113
2603009,CABROBÓ,PE,0.854,0.146,14392,2468,16860
2607802,ITAQUITINGA,PE,0.743,0.257,7064,2443,9507
2601300,BARRA DE GUABIRABA,PE,0.645,0.355,4415,2426,6841
2614105,SERTÂNIA,PE,0.867,0.133,15700,2417,18117
2609709,OROBÓ,PE,0.809,0.191,10036,2369,12405
2613800,SÃO VICENTE FÉRRER,PE,0.759,0.241,7430,2357,9787
2612000,SAIRÉ,PE,0.709,0.291,5667,2326,7993
2615508,TRACUNHAÉM,PE,0.713,0.287,5693,2287,7980
2612406,SANHARÓ,PE,0.807,0.193,9452,2258,11710
2608750,LAGOA GRANDE,PE,0.831,0.169,11096,2250,13346
2607307,IPUBI,PE,0.849,0.151,12493,2223,14716
2612703,SANTA MARIA DO CAMBUCÁ,PE,0.728,0.272,5767,2158,7925
2605806,FREI MIGUELINHO,PE,0.76,0.24,6818,2150,8968
2613503,SÃO JOSÉ DO BELMONTE,PE,0.884,0.116,16021,2106,18127
2600203,AFRÂNIO,PE,0.811,0.189,8991,2094,11085
2610806,PEDRA,PE,0.831,0.169,10263,2091,12354
2614600,TABIRA,PE,0.863,0.137,13138,2083,15221
2605103,CUSTÓDIA,PE,0.892,0.108,17174,2079,19253
2604908,CUMARU,PE,0.789,0.211,7698,2060,9758
2605707,FLORESTA,PE,0.88,0.12,14692,2005,16697
2604403,CHÃ DE ALEGRIA,PE,0.758,0.242,6198,1974,8172
2605301,EXU,PE,0.9,0.1,17637,1954,19591
2605152,DORMENTES,PE,0.821,0.179,8858,1936,10794
2605509,FERREIROS,PE,0.72,0.28,4955,1925,6880
2604809,CORTÊS,PE,0.749,0.251,5651,1892,7543
2611408,PRIMAVERA,PE,0.751,0.249,5692,1891,7583
2608206,JOAQUIM NABUCO,PE,0.774,0.226,6206,1813,8019
2603603,CAMUTANGA,PE,0.689,0.311,3725,1684,5409
2613206,SÃO JOÃO,PE,0.86,0.14,10263,1668,11931
2608008,JATAÚBA,PE,0.827,0.173,7908,1652,9560
2602001,BODOCÓ,PE,0.91,0.09,16517,1629,18146
2601003,ANGELIM,PE,0.737,0.263,4517,1612,6129
2614709,TACAIMBÓ,PE,0.78,0.22,5724,1610,7334
2608404,JUREMA,PE,0.798,0.202,6347,1609,7956
2602704,BUENOS AIRES,PE,0.804,0.196,6516,1593,8109
2616506,XEXÉU,PE,0.768,0.232,5216,1573,6789
2611507,QUIPAPÁ,PE,0.847,0.153,8677,1564,10241
2607703,ITAPETIM,PE,0.826,0.174,7053,1485,8538
2607950,JAQUEIRA,PE,0.747,0.253,4348,1469,5817
2616001,VENTUROSA,PE,0.85,0.15,8289,1467,9756
2609105,MACHADOS,PE,0.801,0.199,5892,1461,7353
2609808,OROCÓ,PE,0.823,0.177,6669,1438,8107
2607505,ITAÍBA,PE,0.886,0.114,11188,1436,12624
2602407,BREJÃO,PE,0.799,0.201,5569,1401,6970
2604155,CASINHAS,PE,0.841,0.159,7251,1375,8626
2606606,IBIMIRIM,PE,0.9,0.1,12337,1367,13704
2608701,LAGOA DOS GATOS,PE,0.827,0.173,6491,1358,7849
2601508,BELÉM DE MARIA,PE,0.784,0.216,4917,1356,6273
2615805,TUPANATINGA,PE,0.875,0.125,9393,1344,10737
2601607,BELÉM DO SÃO FRANCISCO,PE,0.881,0.119,9946,1341,11287
2608305,JUPI,PE,0.847,0.153,7285,1311,8596
2615706,TRIUNFO,PE,0.847,0.153,7109,1286,8395
2614808,TACARATU,PE,0.892,0.108,10527,1274,11801
2605608,FLORES,PE,0.893,0.107,10591,1266,11857
2609303,MIRANDIBA,PE,0.851,0.149,7095,1242,8337
2609204,MARAIAL,PE,0.777,0.223,4190,1206,5396
2603900,CARNAÍBA,PE,0.892,0.108,9624,1163,10787
2603801,CAPOEIRAS,PE,0.888,0.112,9205,1157,10362
2603207,CAETÉS,PE,0.917,0.083,12333,1112,13445
2606507,IATI,PE,0.89,0.11,8854,1094,9948
2600609,ALAGOINHA,PE,0.88,0.12,7753,1057,8810
2608057,JATOBÁ,PE,0.863,0.137,6639,1057,7696
2610400,PARNAMIRIM,PE,0.917,0.083,11606,1049,12655
2610301,PARANATAMA,PE,0.871,0.129,6520,969,7489
2612307,SALOÁ,PE,0.887,0.113,7509,953,8462
2604700,CORRENTES,PE,0.891,0.109,7755,951,8706
2614006,SERRITA,PE,0.911,0.089,9763,948,10711
2616183,VERTENTE DO LÉRIO,PE,0.831,0.169,4628,944,5572
2611200,POÇÃO,PE,0.865,0.135,5977,930,6907
2608602,LAGOA DO OURO,PE,0.879,0.121,6763,928,7691
2612471,SANTA CRUZ DA BAIXA VERDE,PE,0.868,0.132,6019,917,6936
2612109,SALGADINHO,PE,0.792,0.208,3471,909,4380
2608255,JUCATI,PE,0.871,0.129,6003,886,6889
2606903,IGUARACY,PE,0.86,0.14,5368,876,6244
2612901,SÃO BENEDITO DO SUL,PE,0.83,0.17,4105,843,4948
2612455,SANTA CRUZ,PE,0.895,0.105,6969,819,7788
2606705,IBIRAJUBA,PE,0.822,0.178,3780,817,4597
2612802,SANTA TEREZINHA,PE,0.854,0.146,4733,808,5541
2605459,FERNANDO DE NORONHA,PE,0.489,0.511,748,783,1531
2612554,SANTA FILOMENA,PE,0.9,0.1,6970,773,7743
2602506,BREJINHO,PE,0.851,0.149,4174,732,4906
2604304,CEDRO,PE,0.892,0.108,5812,707,6519
2607000,INAJÁ,PE,0.93,0.07,9057,682,9739
2609154,MANARI,PE,0.924,0.076,8297,681,8978
2615904,TUPARETAMA,PE,0.891,0.109,5203,637,5840
2603306,CALÇADO,PE,0.874,0.126,4428,637,5065
2615102,TEREZINHA,PE,0.861,0.139,3900,630,4530
2616100,VERDEJANTE,PE,0.891,0.109,5051,616,5667
2614303,MOREILÂNDIA,PE,0.92,0.08,6120,533,6653
2606309,GRANITO,PE,0.883,0.117,4001,528,4529
2601805,BETÂNIA,PE,0.919,0.081,5770,508,6278
2610103,PALMEIRINA,PE,0.888,0.112,3768,474,4242
2615201,TERRA NOVA,PE,0.923,0.077,5641,469,6110
2603405,CALUMBI,PE,0.91,0.09,4270,424,4694
2614402,SOLIDÃO,PE,0.9,0.1,3588,400,3988
2607109,INGAZEIRA,PE,0.875,0.125,2637,377,3014
2603926,CARNAUBEIRA DA PENHA,PE,0.952,0.048,7402,371,7773
2611533,QUIXABA,PE,0.927,0.073,4169,329,4498
2607406,ITACURUBA,PE,0.904,0.096,2737,291,3028
2211001,TERESINA,PI,0.627,0.373,273796,162652,436448
2207702,PARNAÍBA,PI,0.625,0.375,49323,29587,78910
2208007,PICOS,PI,0.747,0.253,30013,10143,40156
2208403,PIRIPIRI,PI,0.755,0.245,26562,8628,35190
2203909,FLORIANO,PI,0.749,0.251,24011,8059,32070
2202208,CAMPO MAIOR,PI,0.745,0.255,19618,6730,26348
2203701,ESPERANTINA,PI,0.738,0.262,15553,5532,21085
2211100,UNIÃO,PI,0.797,0.203,21387,5457,26844
2201200,BARRAS,PI,0.792,0.208,20081,5265,25346
2207900,PEDRO II,PI,0.784,0.216,17051,4697,21748
2200400,ALTOS,PI,0.827,0.173,20732,4338,25070
2201903,BOM JESUS,PI,0.706,0.294,9266,3864,13130
2208304,PIRACURUCA,PI,0.777,0.223,13153,3782,16935
2211209,URUÇUÍ,PI,0.704,0.296,8495,3572,12067
2207009,OEIRAS,PI,0.831,0.169,17087,3464,20551
2201507,BATALHA,PI,0.771,0.229,11595,3441,15036
2202901,CORRENTE,PI,0.756,0.244,10628,3426,14054
2205706,LUÍS CORREIA,PI,0.813,0.187,14659,3376,18035
2205508,JOSÉ DE FREITAS,PI,0.868,0.132,21909,3335,25244
2205805,LUZILÂNDIA,PI,0.785,0.215,10839,2966,13805
2202703,COCAL,PI,0.805,0.195,11960,2894,14854
2200202,ÁGUA BRANCA,PI,0.739,0.261,7942,2799,10741
2206209,MIGUEL ALVES,PI,0.846,0.154,14530,2649,17179
2210607,SÃO RAIMUNDO NONATO,PI,0.862,0.138,15701,2518,18219
2202604,CASTELO DO PIAUÍ,PI,0.775,0.225,8423,2452,10875
2211308,VALENÇA DO PIAUÍ,PI,0.795,0.205,9302,2399,11701
2202000,BURITI DOS LOPES,PI,0.82,0.18,9979,2191,12170
2202307,CANTO DO BURITI,PI,0.805,0.195,8607,2080,10687
2203305,DEMERVAL LOBÃO,PI,0.791,0.209,6833,1807,8640
2210003,SÃO JOÃO DO PIAUÍ,PI,0.836,0.164,9233,1805,11038
2205409,JOAQUIM PIRES,PI,0.788,0.212,6557,1760,8317
2210508,SÃO PEDRO DO PIAUÍ,PI,0.785,0.215,6130,1681,7811
2201150,BAIXA GRANDE DO RIBEIRO,PI,0.757,0.243,5007,1605,6612
2207801,PAULISTANA,PI,0.864,0.136,10068,1585,11653
2206720,NAZÁRIA,PI,0.814,0.186,6494,1485,7979
2209971,SÃO JOÃO DO ARRAIAL,PI,0.717,0.283,3666,1447,5113
2200301,ALTO LONGÁ,PI,0.836,0.164,7351,1445,8796
2200509,AMARANTE,PI,0.864,0.136,9036,1419,10455
2204709,INHUMA,PI,0.842,0.158,7387,1389,8776
2210409,SÃO MIGUEL DO TAPUIO,PI,0.871,0.129,9062,1340,10402
2206407,MONSENHOR GIL,PI,0.823,0.177,6058,1303,7361
2208106,PIMENTEIRAS,PI,0.808,0.192,5179,1228,6407
2205201,JAICÓS,PI,0.871,0.129,8220,1221,9441
2209708,SÃO FRANCISCO DO PIAUÍ,PI,0.706,0.294,2838,1182,4020
2205102,ITAUEIRA,PI,0.81,0.19,4986,1172,6158
2201101,AVELINO LOPES,PI,0.823,0.177,5444,1169,6613
2207504,PALMEIRAIS,PI,0.865,0.135,7351,1145,8496
2208205,PIO IX,PI,0.892,0.108,9309,1132,10441
2208809,REGENERAÇÃO,PI,0.884,0.116,8554,1126,9680
2204303,FRONTEIRAS,PI,0.833,0.167,5603,1121,6724
2203503,ELESBÃO VELOSO,PI,0.872,0.128,7653,1120,8773
2205953,MARCOLÂNDIA,PI,0.797,0.203,4325,1100,5425
2210300,SÃO JULIÃO,PI,0.723,0.277,2871,1098,3969
2204501,GUADALUPE,PI,0.812,0.188,4730,1094,5824
2210706,SIMÕES,PI,0.868,0.132,7179,1089,8268
2206100,MATIAS OLÍMPIO,PI,0.817,0.183,4836,1081,5917
2206803,NOSSA SENHORA DOS REMÉDIOS,PI,0.811,0.189,4597,1073,5670
2204659,ILHA GRANDE,PI,0.821,0.179,4885,1067,5952
2210805,SIMPLÍCIO MENDES,PI,0.848,0.152,5844,1048,6892
2201408,BARRO DURO,PI,0.763,0.237,3184,987,4171
2203206,CURIMATÁ,PI,0.837,0.163,4983,968,5951
2202406,CAPITÃO DE CAMPOS,PI,0.861,0.139,5947,959,6906
2201606,BENEDITINOS,PI,0.861,0.139,5941,957,6898
2205003,ITAINÓPOLIS,PI,0.864,0.136,6014,947,6961
2208700,REDENÇÃO DO GURGUÉIA,PI,0.791,0.209,3568,945,4513
2206357,MILTON BRANDÃO,PI,0.776,0.224,3241,936,4177
2200251,ALAGOINHA DO PIAUÍ,PI,0.802,0.198,3735,924,4659
2203107,CRISTINO CASTRO,PI,0.829,0.171,4411,908,5319
2204204,FRANCISCO SANTOS,PI,0.824,0.176,4242,907,5149
2208908,RIBEIRO GONÇALVES,PI,0.741,0.259,2582,903,3485
2210631,SEBASTIÃO LEAL,PI,0.689,0.311,1972,890,2862
2209377,SANTA ROSA DO PIAUÍ,PI,0.722,0.278,2269,872,3141
2200608,ANGICAL DO PIAUÍ,PI,0.811,0.189,3734,869,4603
2204402,GILBUÉS,PI,0.841,0.159,4538,858,5396
2206605,MONTE ALEGRE DO PIAUÍ,PI,0.857,0.143,5063,847,5910
2210656,SIGEFREDO PACHECO,PI,0.862,0.138,5200,830,6030
2201919,BOM PRINCÍPIO DO PIAUÍ,PI,0.811,0.189,3544,825,4369
2209807,SÃO GONÇALO DO PIAUÍ,PI,0.747,0.253,2435,823,3258
2202083,CAJUEIRO DA PRAIA,PI,0.835,0.165,4107,813,4920
2203404,DOM EXPEDITO LOPES,PI,0.832,0.168,3949,795,4744
2209906,SÃO JOÃO DA SERRA,PI,0.821,0.179,3637,794,4431
2201804,BOCAINA,PI,0.803,0.197,3143,772,3915
2209302,SANTA LUZ,PI,0.773,0.227,2620,771,3391
2202737,COIVARAS,PI,0.789,0.211,2844,759,3603
2210938,SUSSUAPARA,PI,0.846,0.154,4164,758,4922
2202539,CARAÚBAS DO PIAUÍ,PI,0.782,0.218,2723,758,3481
2206506,MONSENHOR HIPÓLITO,PI,0.847,0.153,4190,757,4947
2208502,PORTO,PI,0.872,0.128,5140,752,5892
2206001,MARCOS PARENTE,PI,0.729,0.271,1965,730,2695
2207306,PAES LANDIM,PI,0.731,0.269,1944,717,2661
2201960,BRASILEIRA,PI,0.86,0.14,4331,705,5036
2202059,CABECEIRAS DO PIAUÍ,PI,0.893,0.107,5733,688,6421
2202505,CARACOL,PI,0.883,0.117,5192,685,5877
2205557,LAGOA ALEGRE,PI,0.883,0.117,5020,668,5688
2209203,SANTA FILOMENA,PI,0.806,0.194,2753,663,3416
2206696,MURICI DOS PORTELAS,PI,0.843,0.157,3534,658,4192
2209104,SANTA CRUZ DO PIAUÍ,PI,0.843,0.157,3505,655,4160
2205516,JUAZEIRO DO PIAUÍ,PI,0.829,0.171,3179,654,3833
2201705,BERTOLÍNIA,PI,0.812,0.188,2743,634,3377
2201770,BOA HORA,PI,0.853,0.147,3642,630,4272
2205581,LAGOA DO PIAUÍ,PI,0.805,0.195,2571,624,3195
2200103,AGRICOLÂNDIA,PI,0.826,0.174,2963,623,3586
2210201,SÃO JOSÉ DO PIAUÍ,PI,0.858,0.142,3693,612,4305
2207603,PARNAGUÁ,PI,0.881,0.119,4537,610,5147
2200707,ANÍSIO DE ABREU,PI,0.88,0.12,4455,605,5060
2206670,MORRO DO CHAPÉU DO PIAUÍ,PI,0.838,0.162,3108,599,3707
2209401,SANTO ANTÔNIO DE LISBOA,PI,0.849,0.151,3375,598,3973
2202174,CAMPO LARGO DO PIAUÍ,PI,0.83,0.17,2870,589,3459
2204352,GEMINIANO,PI,0.869,0.131,3879,586,4465
2200806,ANTÔNIO ALMEIDA,PI,0.703,0.297,1389,586,1975
2202752,COLÔNIA DO GURGUÉIA,PI,0.836,0.164,2973,585,3558
2203602,ELISEU MARTINS,PI,0.772,0.228,1974,584,2558
2202653,CAXINGÓ,PI,0.852,0.148,3266,569,3835
2204808,IPIRANGA DO PIAUÍ,PI,0.895,0.105,4837,568,5405
2207405,PALMEIRA DO PIAUÍ,PI,0.819,0.181,2565,568,3133
2205854,MADEIRO,PI,0.873,0.127,3872,564,4436
2205276,JATOBÁ DO PIAUÍ,PI,0.867,0.133,3677,562,4239
2203008,CRISTALÂNDIA DO PIAUÍ,PI,0.851,0.149,3196,561,3757
2207207,PADRE MARCOS,PI,0.87,0.13,3766,561,4327
2211704,WALL FERRAZ,PI,0.807,0.193,2284,547,2831
2210052,SÃO JOSÉ DO DIVINO,PI,0.851,0.149,3124,546,3670
2201051,ASSUNÇÃO DO PIAUÍ,PI,0.885,0.115,4053,528,4581
2209609,SÃO FÉLIX DO PIAUÍ,PI,0.779,0.221,1828,520,2348
2209658,SÃO FRANCISCO DE ASSIS DO PIAUÍ,PI,0.847,0.153,2846,513,3359
2204600,HUGO NAPOLEÃO,PI,0.812,0.188,2204,509,2713
2205904,MANOEL EMÍDIO,PI,0.841,0.159,2687,508,3195
2202091,CALDEIRÃO GRANDE DO PIAUÍ,PI,0.861,0.139,3143,507,3650
2205300,JERUMENHA,PI,0.838,0.162,2628,507,3135
2207777,PATOS DO PIAUÍ,PI,0.87,0.13,3353,502,3855
2200277,ALEGRETE DO PIAUÍ,PI,0.844,0.156,2687,498,3185
2203230,CURRAIS,PI,0.87,0.13,3284,490,3774
2207793,PAU D'ARCO DO PIAUÍ,PI,0.859,0.141,2971,488,3459
2207751,PASSAGEM FRANCA DO PIAUÍ,PI,0.824,0.176,2216,474,2690
2202026,BURITI DOS MONTES,PI,0.895,0.105,4006,472,4478
2208650,QUEIMADA NOVA,PI,0.908,0.092,4673,471,5144
2202778,COLÔNIA DO PIAUÍ,PI,0.898,0.102,3994,453,4447
2209005,RIO GRANDE DO PIAUÍ,PI,0.879,0.121,3275,449,3724
2205250,JARDIM DO MULATO,PI,0.847,0.153,2460,446,2906
2205607,LANDRI SALES,PI,0.855,0.145,2604,443,3047
2209872,SÃO JOÃO DA FRONTEIRA,PI,0.869,0.131,2919,441,3360
2210904,SOCORRO DO PIAUÍ,PI,0.843,0.157,2362,441,2803
2203453,DOM INOCÊNCIO,PI,0.915,0.085,4696,439,5135
2211407,VÁRZEA GRANDE,PI,0.832,0.168,2180,439,2619
2206753,NOSSA SENHORA DE NAZARÉ,PI,0.886,0.114,3388,437,3825
2200905,AROAZES,PI,0.884,0.116,3330,436,3766
2200053,ACAUÃ,PI,0.907,0.093,4196,428,4624
2205532,JUREMA,PI,0.878,0.122,3034,421,3455
2205573,LAGOA DE SÃO FRANCISCO,PI,0.891,0.109,3379,414,3793
2201945,BOQUEIRÃO DO PIAUÍ,PI,0.89,0.11,3346,413,3759
2210623,SEBASTIÃO BARROS,PI,0.855,0.145,2433,411,2844
2203255,CURRALINHOS,PI,0.872,0.128,2777,408,3185
2204105,FRANCISCO AYRES,PI,0.861,0.139,2493,402,2895
2210383,SÃO MIGUEL DA BAIXA GRANDE,PI,0.759,0.241,1263,400,1663
2205458,JOCA MARQUES,PI,0.878,0.122,2861,399,3260
2209500,SANTO INÁCIO DO PIAUÍ,PI,0.836,0.164,2034,398,2432
2203800,FLORES DO PIAUÍ,PI,0.863,0.137,2475,394,2869
2200954,AROEIRAS DO ITAIM,PI,0.86,0.14,2414,393,2807
2209351,SANTANA DO PIAUÍ,PI,0.87,0.13,2618,391,3009
2206704,NAZARÉ DO PIAUÍ,PI,0.913,0.087,4042,387,4429
2202554,CARIDADE DO PIAUÍ,PI,0.883,0.117,2911,384,3295
2209856,SÃO JOÃO DA CANABRAVA,PI,0.882,0.118,2868,383,3251
2200459,ALVORADA DO GURGUÉIA,PI,0.872,0.128,2572,379,2951
2201309,BARREIRAS DO PIAUÍ,PI,0.805,0.195,1557,378,1935
2202802,CONCEIÇÃO DO CANINDÉ,PI,0.883,0.117,2776,368,3144
2202729,COCAL DOS ALVES,PI,0.908,0.092,3579,364,3943
2207355,PAJEÚ DO PIAUÍ,PI,0.838,0.162,1870,362,2232
2205524,JÚLIO BORGES,PI,0.887,0.113,2832,360,3192
2206902,NOVO ORIENTE DO PIAUÍ,PI,0.905,0.095,3389,356,3745
2211605,VILA NOVA DO PIAUÍ,PI,0.84,0.16,1810,346,2156
2205599,LAGOA DO SÍTIO,PI,0.882,0.118,2586,345,2931
2202133,CAMPO GRANDE DO PIAUÍ,PI,0.908,0.092,3402,344,3746
2205151,JACOBINA DO PIAUÍ,PI,0.909,0.091,3386,340,3726
2206951,NOVO SANTO ANTÔNIO,PI,0.881,0.119,2511,338,2849
2204006,FRANCINÓPOLIS,PI,0.885,0.115,2558,333,2891
2207553,PAQUETÁ,PI,0.89,0.11,2565,318,2883
2203420,DOMINGOS MOURÃO,PI,0.877,0.123,2255,316,2571
2208858,RIACHO FRIO,PI,0.891,0.109,2586,315,2901
2201002,ARRAIAL,PI,0.892,0.108,2533,308,2841
2203354,DIRCEU ARCOVERDE,PI,0.928,0.072,3935,305,4240
2209153,SANTA CRUZ DOS MILAGRES,PI,0.868,0.132,2001,305,2306
2209757,SÃO GONÇALO DO GURGUÉIA,PI,0.801,0.199,1224,304,1528
2202251,CANAVIEIRA,PI,0.852,0.148,1747,304,2051
2201176,BARRA D'ALCÂNTARA,PI,0.873,0.127,2042,297,2339
2207934,PEDRO LAURENTINO,PI,0.852,0.148,1629,284,1913
2210102,SÃO JOSÉ DO PEIXE,PI,0.871,0.129,1895,280,2175
2205540,LAGOINHA DO PIAUÍ,PI,0.858,0.142,1680,279,1959
2207108,OLHO D'ÁGUA DO PIAUÍ,PI,0.841,0.159,1467,278,1745
2204907,ISAÍAS COELHO,PI,0.939,0.061,4246,278,4524
2206308,MIGUEL LEÃO,PI,0.724,0.276,731,278,1009
2201739,BETÂNIA DO PIAUÍ,PI,0.931,0.069,3696,275,3971
2210359,SÃO LOURENÇO DO PIAUÍ,PI,0.922,0.078,3233,274,3507
2205565,LAGOA DO BARRO DO PIAUÍ,PI,0.915,0.085,2920,273,3193
2211357,VÁRZEA BRANCA,PI,0.915,0.085,2875,266,3141
2209955,SÃO JOÃO DA VARJOTA,PI,0.908,0.092,2605,263,2868
2206050,MASSAPÊ DO PIAUÍ,PI,0.937,0.063,3833,259,4092
2208551,PORTO ALEGRE DO PIAUÍ,PI,0.814,0.186,1114,254,1368
2210979,TANQUE DO PIAUÍ,PI,0.851,0.149,1448,253,1701
2202109,CAMPINAS DO PIAUÍ,PI,0.932,0.068,3405,250,3655
2202711,COCAL DE TELHA,PI,0.92,0.08,2836,245,3081
2208601,PRATA DO PIAUÍ,PI,0.889,0.111,1964,244,2208
2202075,CAJAZEIRAS DO PIAUÍ,PI,0.894,0.106,2026,241,2267
2201988,BREJO DO PIAUÍ,PI,0.914,0.086,2508,235,2743
2201572,BELÉM DO PIAUÍ,PI,0.893,0.107,1970,235,2205
2202117,CAMPO ALEGRE DO FIDALGO,PI,0.929,0.071,3034,233,3267
2210953,TAMBORIL DO PIAUÍ,PI,0.88,0.12,1655,226,1881
2204154,FRANCISCO MACEDO,PI,0.887,0.113,1748,223,1971
2203271,CURRAL NOVO DO PIAUÍ,PI,0.93,0.07,2907,220,3127
2206654,MORRO CABEÇA NO TEMPO,PI,0.914,0.086,2256,213,2469
2202851,CORONEL JOSÉ DIAS,PI,0.941,0.059,3312,209,3521
2210375,SÃO LUIS DO PIAUÍ,PI,0.887,0.113,1603,205,1808
2205359,JOÃO COSTA,PI,0.92,0.08,2156,188,2344
2211506,VERA MENDES,PI,0.923,0.077,2243,187,2430
2208874,RIBEIRA DO PIAUÍ,PI,0.925,0.075,2315,187,2502
2207959,NOVA SANTA RITA,PI,0.937,0.063,2685,180,2865
2201929,BONFIM DO PIAUÍ,PI,0.948,0.052,3241,179,3420
2209450,SANTO ANTÔNIO DOS MILAGRES,PI,0.866,0.134,1140,176,1316
2207850,PAVUSSU,PI,0.933,0.067,2462,176,2638
2203750,FARTURA DO PIAUÍ,PI,0.947,0.053,2978,166,3144
2209559,SÃO BRAZ DO PIAUÍ,PI,0.944,0.056,2720,160,2880
2203859,FLORESTA DO PIAUÍ,PI,0.909,0.091,1576,158,1734
2210391,SÃO MIGUEL DO FIDALGO,PI,0.914,0.086,1678,157,1835
2201556,BELA VISTA DO PIAUÍ,PI,0.944,0.056,2607,155,2762
2202455,CAPITÃO GERVÁSIO OLIVEIRA,PI,0.957,0.043,2667,121,2788
2204550,GUARIBAS,PI,0.98,0.02,2879,59,2938
3304557,RIO DE JANEIRO,RJ,0.336,0.664,1105393,2179896,3285289
3304904,SÃO GONÇALO,RJ,0.326,0.674,149075,307577,456652
3301702,DUQUE DE CAXIAS,RJ,0.312,0.688,136240,300227,436467
3303500,NOVA IGUAÇU,RJ,0.275,0.725,110820,291877,402697
3305109,SÃO JOÃO DE MERITI,RJ,0.285,0.715,70499,176534,247033
3303302,NITERÓI,RJ,0.375,0.625,105606,175730,281336
3300456,BELFORD ROXO,RJ,0.311,0.689,69174,153078,222252
3301009,CAMPOS DOS GOYTACAZES,RJ,0.351,0.649,79838,147437,227275
3303906,PETRÓPOLIS,RJ,0.258,0.742,40665,116947,157612
3306305,VOLTA REDONDA,RJ,0.359,0.641,56080,100256,156336
3302502,MAGÉ,RJ,0.309,0.691,37416,83510,120926
3301900,ITABORAÍ,RJ,0.34,0.66,38886,75544,114430
3300704,CABO FRIO,RJ,0.239,0.761,23520,74772,98292
3303401,NOVA FRIBURGO,RJ,0.272,0.728,26805,71859,98664
3303203,NILÓPOLIS,RJ,0.282,0.718,26814,68352,95166
3302858,MESQUITA,RJ,0.283,0.717,26728,67824,94552
3302403,MACAÉ,RJ,0.35,0.65,36212,67223,103435
3305802,TERESÓPOLIS,RJ,0.21,0.79,17579,66081,83660
3300100,ANGRA DOS REIS,RJ,0.257,0.743,21829,63148,84977
3300407,BARRA MANSA,RJ,0.333,0.667,31110,62358,93468
3300209,ARARUAMA,RJ,0.226,0.774,13961,47767,61728
3304201,RESENDE,RJ,0.257,0.743,16429,47443,63872
3302700,MARICÁ,RJ,0.377,0.623,28593,47243,75836
3302007,ITAGUAÍ,RJ,0.25,0.75,15406,46148,61554
3304524,RIO DAS OSTRAS,RJ,0.255,0.745,14202,41487,55689
3304144,QUEIMADOS,RJ,0.315,0.685,17884,38830,56714
3302205,ITAPERUNA,RJ,0.263,0.737,13120,36707,49827
3305208,SÃO PEDRO DA ALDEIA,RJ,0.194,0.806,8363,34748,43111
3302270,JAPERI,RJ,0.335,0.665,16143,32013,48156
3305505,SAQUAREMA,RJ,0.24,0.76,9857,31251,41108
3300308,BARRA DO PIRAÍ,RJ,0.357,0.643,16806,30218,47024
3305554,SEROPÉDICA,RJ,0.282,0.718,10695,27258,37953
3306008,TRÊS RIOS,RJ,0.439,0.561,18369,23461,41830
3304300,RIO BONITO,RJ,0.267,0.733,8303,22743,31046
3306107,VALENÇA,RJ,0.436,0.564,15920,20623,36543
3300803,CACHOEIRAS DE MACACU,RJ,0.323,0.677,9565,20042,29607
3302601,MANGARATIBA,RJ,0.236,0.764,5796,18723,24519
3301850,GUAPIMIRIM,RJ,0.325,0.675,8525,17709,26234
3303609,PARACAMBI,RJ,0.304,0.696,7108,16288,23396
3301306,CASIMIRO DE ABREU,RJ,0.245,0.755,5101,15731,20832
3304706,SANTO ANTÔNIO DE PÁDUA,RJ,0.287,0.713,6298,15663,21961
3304755,SÃO FRANCISCO DE ITABAPOANA,RJ,0.289,0.711,6269,15425,21694
3305000,SÃO JOÃO DA BARRA,RJ,0.356,0.644,8219,14866,23085
3303708,PARAÍBA DO SUL,RJ,0.335,0.665,7328,14535,21863
3304805,SÃO FIDÉLIS,RJ,0.255,0.745,4892,14256,19148
3300258,ARRAIAL DO CABO,RJ,0.253,0.747,4751,14047,18798
3300233,ARMAÇÃO DOS BÚZIOS,RJ,0.259,0.741,4869,13938,18807
3303807,PARATY,RJ,0.302,0.698,5787,13359,19146
3300605,BOM JESUS DO ITABAPOANA,RJ,0.346,0.654,6634,12540,19174
3301876,IGUABA GRANDE,RJ,0.216,0.784,3300,12008,15308
3306206,VASSOURAS,RJ,0.366,0.634,6904,11972,18876
3302254,ITATIAIA,RJ,0.307,0.693,5194,11721,16915
3305752,TANGUÁ,RJ,0.353,0.647,5901,10803,16704
3302908,MIGUEL PEREIRA,RJ,0.313,0.687,4677,10264,14941
3303856,PATY DO ALFERES,RJ,0.316,0.684,4660,10064,14724
3302106,ITAOCARA,RJ,0.233,0.767,3047,10021,13068
3300506,BOM JARDIM,RJ,0.313,0.687,4304,9457,13761
3304003,PIRAÍ,RJ,0.382,0.618,5777,9342,15119
3305158,SÃO JOSÉ DO VALE DO RIO PRETO,RJ,0.151,0.849,1656,9305,10961
3305604,SILVA JARDIM,RJ,0.284,0.716,3376,8495,11871
3303005,MIRACEMA,RJ,0.431,0.569,6033,7970,14003
3304110,PORTO REAL,RJ,0.334,0.666,3931,7836,11767
3301504,CORDEIRO,RJ,0.322,0.678,3478,7339,10817
3301108,CANTAGALO,RJ,0.326,0.674,3332,6886,10218
3305406,SAPUCAIA,RJ,0.365,0.635,3946,6877,10823
3303955,PINHEIRAL,RJ,0.445,0.555,5410,6759,12169
3305703,SUMIDOURO,RJ,0.281,0.719,2595,6653,9248
3301405,CONCEIÇÃO DE MACABU,RJ,0.393,0.607,4246,6552,10798
3302809,MENDES,RJ,0.365,0.635,3677,6396,10073
3304151,QUISSAMÃ,RJ,0.432,0.568,4752,6250,11002
3304409,RIO CLARO,RJ,0.411,0.589,4138,5920,10058
3302056,ITALVA,RJ,0.26,0.74,1951,5559,7510
3303104,NATIVIDADE,RJ,0.36,0.64,2941,5233,8174
3301207,CARMO,RJ,0.467,0.533,4536,5185,9721
3300936,CARAPEBUS,RJ,0.342,0.658,2635,5059,7694
3300159,APERIBÉ,RJ,0.267,0.733,1794,4925,6719
3300902,CAMBUCI,RJ,0.402,0.598,3299,4917,8216
3301157,CARDOSO MOREIRA,RJ,0.339,0.661,2511,4894,7405
3304102,PORCIÚNCULA,RJ,0.457,0.543,3945,4690,8635
3301801,ENGENHEIRO PAULO DE FRONTIN,RJ,0.367,0.633,2713,4670,7383
3300225,AREAL,RJ,0.32,0.68,2090,4434,6524
3304128,QUATIS,RJ,0.388,0.612,2806,4426,7232
3301603,DUAS BARRAS,RJ,0.395,0.605,2528,3871,6399
3305133,SÃO JOSÉ DE UBÁ,RJ,0.289,0.711,1492,3664,5156
3306156,VARRE-SAI,RJ,0.336,0.664,1764,3490,5254
3304607,SANTA MARIA MADALENA,RJ,0.367,0.633,1894,3272,5166
3305901,TRAJANO DE MORAES,RJ,0.463,0.537,2588,3002,5590
3305307,SÃO SEBASTIÃO DO ALTO,RJ,0.389,0.611,1855,2911,4766
3302452,MACUCO,RJ,0.386,0.614,1815,2881,4696
3304508,RIO DAS FLORES,RJ,0.516,0.484,2881,2699,5580
3300951,COMENDADOR LEVY GASPARIAN,RJ,0.508,0.492,2692,2609,5301
3302304,LAJE DO MURIAÉ,RJ,0.533,0.467,2840,2486,5326
2408102,NATAL,RN,0.47,0.53,195938,220770,416708
2403251,PARNAMIRIM,RN,0.4,0.6,37327,55904,93231
2408003,MOSSORÓ,RN,0.592,0.408,77547,53391,130938
2412005,SÃO GONÇALO DO AMARANTE,RN,0.557,0.443,28141,22383,50524
2407104,MACAÍBA,RN,0.631,0.369,23473,13716,37189
2402006,CAICÓ,RN,0.649,0.351,20999,11374,32373
2402600,CEARÁ-MIRIM,RN,0.747,0.253,29424,9970,39394
2403103,CURRAIS NOVOS,RN,0.612,0.388,13427,8524,21951
2412203,SÃO JOSÉ DE MIPIBU,RN,0.624,0.376,13420,8094,21514
2400208,AÇU,RN,0.772,0.228,24008,7100,31108
2403608,EXTREMOZ,RN,0.581,0.419,9516,6869,16385
2408300,NOVA CRUZ,RN,0.668,0.332,12368,6151,18519
2408201,NÍSIA FLORESTA,RN,0.579,0.421,8243,5985,14228
2408904,PARELHAS,RN,0.507,0.493,6062,5904,11966
2411205,SANTA CRUZ,RN,0.68,0.32,12500,5889,18389
2414407,TOUROS,RN,0.684,0.316,11582,5357,16939
2401107,AREIA BRANCA,RN,0.638,0.362,9365,5315,14680
2404200,GOIANINHA,RN,0.646,0.354,9493,5192,14685
2401008,APODI,RN,0.767,0.233,16465,4994,21459
2407807,MONTE ALEGRE,RN,0.597,0.403,7127,4814,11941
2405801,JOÃO CÂMARA,RN,0.73,0.27,12980,4793,17773
2401453,BARAÚNA,RN,0.681,0.319,9527,4458,13985
2412609,SÃO PAULO DO POTENGI,RN,0.564,0.436,5364,4140,9504
2402204,CANGUARETAMA,RN,0.776,0.224,13388,3874,17262
2404507,GUAMARÉ,RN,0.635,0.365,6397,3681,10078
2409407,PAU DOS FERROS,RN,0.766,0.234,11447,3497,14944
2411502,SANTO ANTÔNIO,RN,0.735,0.265,9498,3420,12918
2407203,MACAU,RN,0.792,0.208,12415,3254,15669
2414605,UPANEMA,RN,0.631,0.369,5204,3047,8251
2414209,TIBAU DO SUL,RN,0.664,0.336,5293,2682,7975
2402303,CARAÚBAS,RN,0.803,0.197,10842,2664,13506
2414001,TANGARÁ,RN,0.662,0.338,5198,2658,7856
2405702,JARDIM DO SERIDÓ,RN,0.632,0.368,4553,2648,7201
2408953,RIO DO FOGO,RN,0.611,0.389,3991,2538,6529
2412906,SÃO TOMÉ,RN,0.605,0.395,3805,2484,6289
2413359,SERRA DO MEL,RN,0.657,0.343,4668,2433,7101
2406106,JUCURUTU,RN,0.775,0.225,8305,2410,10715
2401800,BREJINHO,RN,0.662,0.338,4675,2391,7066
2414803,VERA CRUZ,RN,0.668,0.332,4792,2382,7174
2401206,ARÊS,RN,0.71,0.29,5814,2369,8183
2400802,ANGICOS,RN,0.656,0.344,4434,2328,6762
2400109,ACARI,RN,0.637,0.363,4000,2282,6282
2409100,PASSA E FICA,RN,0.673,0.327,4383,2127,6510
2407500,MAXARANGUAPE,RN,0.663,0.337,4151,2109,6260
2402402,CARNAÚBA DOS DANTAS,RN,0.499,0.501,2061,2071,4132
2406502,LAGOA NOVA,RN,0.755,0.245,6324,2057,8381
2406601,LAGOA SALGADA,RN,0.705,0.295,4461,1867,6328
2404606,IELMO MARINHO,RN,0.756,0.244,5734,1851,7585
2409803,PEDRO VELHO,RN,0.77,0.23,6191,1849,8040
2403509,ESPÍRITO SANTO,RN,0.65,0.35,3418,1838,5256
2404408,GROSSOS,RN,0.694,0.306,4160,1833,5993
2412302,SÃO JOSÉ DO CAMPESTRE,RN,0.736,0.264,5077,1821,6898
2401701,BOM JESUS,RN,0.687,0.313,3855,1755,5610
2412500,SÃO MIGUEL,RN,0.854,0.146,10032,1713,11745
2404309,GOVERNADOR DIX-SEPT ROSADO,RN,0.796,0.204,6671,1706,8377
2409308,PATU,RN,0.759,0.241,5267,1670,6937
2413904,TAIPU,RN,0.791,0.209,5938,1568,7506
2400703,ALTO DO RODRIGUES,RN,0.809,0.191,6587,1554,8141
2401404,BAÍA FORMOSA,RN,0.678,0.322,3279,1554,4833
2409902,PENDÊNCIAS,RN,0.799,0.201,6150,1548,7698
2412559,SÃO MIGUEL DO GOSTOSO,RN,0.728,0.272,4137,1545,5682
2411403,SANTANA DO MATOS,RN,0.811,0.189,6416,1493,7909
2405306,JANUÁRIO CICCO,RN,0.704,0.296,3532,1482,5014
2406700,LAJES,RN,0.756,0.244,4559,1469,6028
2401305,AUGUSTO SEVERO,RN,0.751,0.249,4427,1464,5891
2404705,IPANGUAÇU,RN,0.838,0.162,7522,1450,8972
2403806,FLORÂNIA,RN,0.75,0.25,4238,1414,5652
2400307,AFONSO BEZERRA,RN,0.783,0.217,4917,1363,6280
2410108,POÇO BRANCO,RN,0.831,0.169,6548,1334,7882
2402709,CERRO CORÁ,RN,0.785,0.215,4835,1328,6163
2413409,SERRA NEGRA DO NORTE,RN,0.707,0.293,3181,1319,4500
2407401,MARTINS,RN,0.728,0.272,3487,1304,4791
2402501,CARNAUBAIS,RN,0.796,0.204,5059,1298,6357
2403004,CRUZETA,RN,0.729,0.271,3462,1286,4748
2405603,JARDIM DE PIRANHAS,RN,0.839,0.161,6572,1265,7837
2410900,RIACHUELO,RN,0.723,0.277,3298,1263,4561
2410405,PUREZA,RN,0.759,0.241,3932,1246,5178
2410306,SERRA CAIADA,RN,0.782,0.218,4367,1214,5581
2413508,SERRINHA,RN,0.737,0.263,3408,1214,4622
2407708,MONTANHAS,RN,0.817,0.183,5364,1204,6568
2410207,PORTALEGRE,RN,0.727,0.273,3201,1203,4404
2414506,UMARIZAL,RN,0.806,0.194,4978,1201,6179
2412807,SÃO RAFAEL,RN,0.757,0.243,3679,1182,4861
2412708,SÃO PEDRO,RN,0.743,0.257,3311,1148,4459
2400505,ALEXANDRIA,RN,0.855,0.145,6767,1145,7912
2413003,SÃO VICENTE,RN,0.679,0.321,2410,1140,3550
2414704,VÁRZEA,RN,0.672,0.328,2338,1140,3478
2406304,LAGOA DE PEDRAS,RN,0.774,0.226,3789,1109,4898
2411056,TIBAU,RN,0.683,0.317,2382,1108,3490
2409209,PASSAGEM,RN,0.543,0.457,1313,1107,2420
2401503,BARCELONA,RN,0.65,0.35,2028,1093,3121
2408805,PARAZINHO,RN,0.692,0.308,2405,1071,3476
2414100,TENENTE ANANIAS,RN,0.808,0.192,4411,1051,5462
2404853,ITAJÁ,RN,0.779,0.221,3653,1034,4687
2405108,JANDAÍRA,RN,0.741,0.259,2952,1030,3982
2403400,EQUADOR,RN,0.68,0.32,2189,1030,3219
2412104,SÃO JOÃO DO SABUGI,RN,0.739,0.261,2862,1013,3875
2401859,CAIÇARA DO NORTE,RN,0.699,0.301,2343,1011,3354
2405009,JAÇANÃ,RN,0.765,0.235,3216,990,4206
2409704,PEDRO AVELINO,RN,0.757,0.243,2882,926,3808
2414159,TENENTE LAURENTINO CRUZ,RN,0.748,0.252,2682,905,3587
2413201,SENADOR GEORGINO AVELINO,RN,0.661,0.339,1760,902,2662
2413102,SENADOR ELÓI DE SOUZA,RN,0.759,0.241,2828,899,3727
2403707,FELIPE GUERRA,RN,0.828,0.172,4279,888,5167
2411106,RUY BARBOSA,RN,0.653,0.347,1630,868,2498
2406155,JUNDIÁ,RN,0.679,0.321,1831,864,2695
2412401,SÃO JOSÉ DO SERIDÓ,RN,0.726,0.274,2196,830,3026
2409332,SANTA MARIA,RN,0.744,0.256,2376,816,3192
2402105,CAMPO REDONDO,RN,0.856,0.144,4819,810,5629
2407609,MESSIAS TARGINO,RN,0.76,0.24,2383,752,3135
2413607,SEVERIANO MELO,RN,0.844,0.156,4056,752,4808
2408508,OURO BRANCO,RN,0.768,0.232,2463,744,3207
2406205,LAGOA D'ANTA,RN,0.801,0.199,2979,741,3720
2413300,SERRA DE SÃO BENTO,RN,0.789,0.211,2758,737,3495
2411429,SANTANA DO SERIDÓ,RN,0.601,0.399,1109,736,1845
2411908,SÃO FRANCISCO DO OESTE,RN,0.753,0.247,2235,732,2967
2408706,PARAÚ,RN,0.754,0.246,2185,714,2899
2414456,TRIUNFO POTIGUAR,RN,0.741,0.259,2025,707,2732
2404903,ITAÚ,RN,0.798,0.202,2731,691,3422
2406403,LAGOA DE VELHOS,RN,0.711,0.289,1619,658,2277
2414308,TIMBAÚBA DOS BATISTAS,RN,0.64,0.36,1150,648,1798
2411809,SÃO FERNANDO,RN,0.745,0.255,1889,646,2535
2406809,LAJES PINTADAS,RN,0.821,0.179,2853,621,3474
2405405,JAPI,RN,0.845,0.155,3356,616,3972
2411700,SÃO BENTO DO TRAIRÍ,RN,0.783,0.217,2191,606,2797
2402808,CORONEL EZEQUIEL,RN,0.813,0.187,2602,598,3200
2400901,ANTÔNIO MARTINS,RN,0.856,0.144,3569,598,4167
2400604,ALMINO AFONSO,RN,0.831,0.169,2883,587,3470
2403756,FERNANDO PEDROZA,RN,0.723,0.277,1523,584,2107
2401909,CAIÇARA DO RIO DO VENTO,RN,0.766,0.234,1890,577,2467
2410256,PORTO DO MANGUE,RN,0.831,0.169,2811,571,3382
2409605,PEDRA PRETA,RN,0.72,0.28,1439,560,1999
2401602,BENTO FERNANDES,RN,0.842,0.158,2940,553,3493
2413706,SÍTIO NOVO,RN,0.826,0.174,2602,550,3152
2404101,GALINHOS,RN,0.639,0.361,970,548,1518
2411007,RODOLFO FERNANDES,RN,0.816,0.184,2421,546,2967
2411601,SÃO BENTO DO NORTE,RN,0.766,0.234,1776,544,2320
2408409,OLHO D'ÁGUA DO BORGES,RN,0.823,0.177,2519,540,3059
2407005,LUÍS GOMES,RN,0.898,0.102,4725,539,5264
2407906,MONTE DAS GAMELEIRAS,RN,0.722,0.278,1361,524,1885
2410603,RAFAEL GODEIRO,RN,0.797,0.203,2047,521,2568
2409506,PEDRA GRANDE,RN,0.799,0.201,2056,516,2572
2410504,RAFAEL FERNANDES,RN,0.85,0.15,2873,506,3379
2403202,DOUTOR SEVERIANO,RN,0.882,0.118,3665,491,4156
2413557,SERRINHA DOS PINTOS,RN,0.835,0.165,2427,480,2907
2415008,VILA FLOR,RN,0.767,0.233,1538,468,2006
2405207,JANDUÍS,RN,0.851,0.149,2594,455,3049
2413805,TABOLEIRO GRANDE,RN,0.771,0.229,1524,452,1976
2407302,MARCELINO VIEIRA,RN,0.91,0.09,4459,440,4899
2403301,ENCANTO,RN,0.88,0.12,2999,410,3409
2406007,JOSÉ DA PENHA,RN,0.891,0.109,3335,407,3742
2410702,RIACHO DA CRUZ,RN,0.809,0.191,1644,389,2033
2403905,FRANCISCO DANTAS,RN,0.811,0.189,1630,381,2011
2404002,FRUTUOSO GOMES,RN,0.864,0.136,2328,368,2696
2401651,BODÓ,RN,0.835,0.165,1842,365,2207
2402907,CORONEL JOÃO PESSOA,RN,0.869,0.131,2409,363,2772
2405504,JARDIM DE ANGICOS,RN,0.811,0.189,1532,356,1888
2404804,IPUEIRA,RN,0.755,0.245,1089,353,1442
2406908,LUCRÉCIA,RN,0.867,0.133,2135,327,2462
2405900,JOÃO DIAS,RN,0.836,0.164,1559,305,1864
2407252,MAJOR SALES,RN,0.866,0.134,1946,301,2247
2410801,RIACHO DE SANTANA,RN,0.89,0.11,2262,279,2541
2410009,PILÕES,RN,0.9,0.1,2115,236,2351
2408607,PARANÁ,RN,0.917,0.083,2356,213,2569
2414902,VIÇOSA,RN,0.839,0.161,1043,200,1243
2400406,ÁGUA NOVA,RN,0.908,0.092,1865,190,2055
2414753,VENHA-VER,RN,0.925,0.075,2217,181,2398
4314902,PORTO ALEGRE,RS,0.432,0.568,331419,436643,768062
4305108,CAXIAS DO SUL,RS,0.249,0.751,62109,187051,249160
4304606,CANOAS,RS,0.345,0.655,63161,119862,183023
4313409,NOVO HAMBURGO,RS,0.245,0.755,32641,100374,133015
4314407,PELOTAS,RS,0.456,0.544,81705,97524,179229
4309209,GRAVATAÍ,RS,0.285,0.715,38323,95935,134258
4316907,SANTA MARIA,RS,0.385,0.615,57445,91619,149064
4318705,SÃO LEOPOLDO,RS,0.36,0.64,43166,76586,119752
4314100,PASSO FUNDO,RS,0.357,0.643,38940,70103,109043
4323002,VIAMÃO,RS,0.421,0.579,46975,64617,111592
4300604,ALVORADA,RS,0.382,0.618,35734,57782,93516
4302105,BENTO GONÇALVES,RS,0.185,0.815,12741,56142,68883
4316808,SANTA CRUZ DO SUL,RS,0.332,0.668,25729,51725,77454
4303103,CACHOEIRINHA,RS,0.304,0.696,22310,51143,73453
4315602,RIO GRANDE,RS,0.536,0.464,57742,50082,107824
4320008,SAPUCAIA DO SUL,RS,0.405,0.595,30034,44203,74237
4307005,ERECHIM,RS,0.281,0.719,16527,42360,58887
4322400,URUGUAIANA,RS,0.316,0.684,18684,40426,59110
4301602,BAGÉ,RS,0.434,0.566,27319,35630,62949
4307906,FARROUPILHA,RS,0.199,0.801,8491,34114,42605
4311403,LAJEADO,RS,0.284,0.716,12932,32683,45615
4309308,GUAÍBA,RS,0.39,0.61,20423,31968,52391
4319901,SAPIRANGA,RS,0.319,0.681,14808,31672,46480
4303004,CACHOEIRA DO SUL,RS,0.336,0.664,15395,30445,45840
4307708,ESTEIO,RS,0.382,0.618,18829,30443,49272
4317202,SANTA ROSA,RS,0.307,0.693,13430,30248,43678
4310207,IJUÍ,RS,0.381,0.619,18425,29987,48412
4303905,CAMPO BOM,RS,0.25,0.75,9932,29746,39678
4322608,VENÂNCIO AIRES,RS,0.33,0.67,13231,26905,40136
4317509,SANTO ÂNGELO,RS,0.402,0.598,17692,26347,44039
4322509,VACARIA,RS,0.246,0.754,8247,25243,33490
4317103,SANT'ANA DO LIVRAMENTO,RS,0.479,0.521,23224,25240,48464
4303509,CAMAQUÃ,RS,0.346,0.654,12485,23621,36106
4304705,CARAZINHO,RS,0.335,0.665,11532,22876,34408
4312401,MONTENEGRO,RS,0.327,0.673,10918,22518,33436
4321204,TAQUARA,RS,0.26,0.74,7853,22327,30180
4300406,ALEGRETE,RS,0.459,0.541,18469,21771,40240
4307609,ESTÂNCIA VELHA,RS,0.223,0.777,5921,20689,26610
4306106,CRUZ ALTA,RS,0.389,0.611,13134,20626,33760
4314050,PAROBÉ,RS,0.311,0.689,9058,20047,29105
4304630,CAPÃO DA CANOA,RS,0.274,0.726,7242,19183,26425
4309100,GRAMADO,RS,0.175,0.825,3997,18844,22841
4304507,CANGUÇU,RS,0.41,0.59,12786,18428,31214
4318309,SÃO GABRIEL,RS,0.421,0.579,13220,18188,31408
4311809,MARAU,RS,0.246,0.754,5855,17922,23777
4317400,SANTIAGO,RS,0.37,0.63,10394,17660,28054
4313904,PANAMBI,RS,0.277,0.723,6701,17514,24215
4304408,CANELA,RS,0.23,0.77,5044,16873,21917
4308201,FLORES DA CUNHA,RS,0.121,0.879,2268,16466,18734
4318002,SÃO BORJA,RS,0.501,0.499,16441,16398,32839
4313508,OSÓRIO,RS,0.378,0.622,9789,16099,25888
4308607,GARIBALDI,RS,0.194,0.806,3837,15945,19782
4321600,TRAMANDAÍ,RS,0.337,0.663,7784,15303,23087
4318804,SÃO LOURENÇO DO SUL,RS,0.412,0.588,10676,15254,25930
4310108,IGREJINHA,RS,0.264,0.736,5444,15185,20629
4317608,SANTO ANTÔNIO DA PATRULHA,RS,0.359,0.641,8363,14926,23289
4307807,ESTRELA,RS,0.226,0.774,4327,14841,19168
4321501,TORRES,RS,0.298,0.702,5997,14136,20133
4304804,CARLOS BARBOSA,RS,0.2,0.8,3458,13837,17295
4306403,DOIS IRMÃOS,RS,0.291,0.709,5483,13371,18854
4321451,TEUTÔNIA,RS,0.305,0.695,5657,12878,18535
4322806,VERANÓPOLIS,RS,0.147,0.853,2091,12103,14194
4313300,NOVA PRATA,RS,0.18,0.82,2597,11842,14439
4314803,PORTÃO,RS,0.332,0.668,5801,11685,17486
4308508,FREDERICO WESTPHALEN,RS,0.366,0.634,6713,11651,18364
4316402,ROSÁRIO DO SUL,RS,0.455,0.545,9686,11583,21269
4309407,GUAPORÉ,RS,0.205,0.795,2957,11449,14406
4310603,ITAQUI,RS,0.4,0.6,7372,11048,18420
4313201,NOVA PETRÓPOLIS,RS,0.17,0.83,2172,10608,12780
4304200,CANDELÁRIA,RS,0.371,0.629,6168,10474,16642
4319000,SÃO MARCOS,RS,0.159,0.841,1960,10338,12298
4315701,RIO PARDO,RS,0.52,0.48,11054,10198,21252
4321709,TRÊS COROAS,RS,0.255,0.745,3489,10171,13660
4306601,DOM PEDRITO,RS,0.485,0.515,9557,10132,19689
4305355,CHARQUEADAS,RS,0.442,0.558,8026,10125,18151
4322004,TRIUNFO,RS,0.344,0.656,5263,10016,15279
4320909,TAPEJARA,RS,0.22,0.78,2818,9981,12799
4306809,ENCANTADO,RS,0.241,0.759,3140,9897,13037
4311304,LAGOA VERMELHA,RS,0.355,0.645,5367,9759,15126
4306767,ELDORADO DO SUL,RS,0.414,0.586,6858,9705,16563
4321808,TRÊS DE MAIO,RS,0.319,0.681,4500,9625,14125
4321303,TAQUARI,RS,0.362,0.638,5392,9523,14915
4318903,SÃO LUIZ GONZAGA,RS,0.478,0.522,8728,9521,18249
4313706,PALMEIRA DAS MISSÕES,RS,0.458,0.542,8010,9490,17500
4301008,ARROIO DO MEIO,RS,0.268,0.732,3421,9339,12760
4310801,IVOTI,RS,0.235,0.765,2863,9333,12196
4310009,IBIRUBÁ,RS,0.292,0.708,3685,8953,12638
4320800,SOLEDADE,RS,0.45,0.55,7203,8802,16005
4322707,VERA CRUZ,RS,0.392,0.608,5683,8796,14479
4319505,SÃO SEBASTIÃO DO CAÍ,RS,0.295,0.705,3662,8758,12420
4316006,ROLANTE,RS,0.284,0.716,3440,8657,12097
4310330,IMBÉ,RS,0.319,0.681,3952,8420,12372
4321907,TRÊS PASSOS,RS,0.408,0.592,5713,8297,14010
4320107,SARANDI,RS,0.337,0.663,4163,8181,12344
4313375,NOVA SANTA RITA,RS,0.362,0.638,4644,8171,12815
4302808,CAÇAPAVA DO SUL,RS,0.525,0.475,8960,8113,17073
4311007,JAGUARÃO,RS,0.458,0.542,6699,7930,14629
4309605,HORIZONTINA,RS,0.304,0.696,3446,7891,11337
4317301,SANTA VITÓRIA DO PALMAR,RS,0.513,0.487,8032,7615,15647
4318507,SÃO JOSÉ DO NORTE,RS,0.482,0.518,6976,7503,14479
4313060,NOVA HARTZ,RS,0.327,0.673,3617,7460,11077
4320404,SERAFINA CORRÊA,RS,0.224,0.776,2121,7339,9460
4316600,SANANDUVA,RS,0.281,0.719,2862,7328,10190
4308904,GETÚLIO VARGAS,RS,0.267,0.733,2639,7244,9883
4300802,ANTÔNIO PRADO,RS,0.149,0.851,1250,7131,8381
4315305,QUARAÍ,RS,0.436,0.564,5429,7015,12444
4312658,NÃO-ME-TOQUE,RS,0.306,0.694,3087,7007,10094
4302352,BOM PRINCÍPIO,RS,0.167,0.833,1355,6741,8096
4304663,CAPÃO DO LEÃO,RS,0.477,0.523,5953,6517,12470
4322202,TUPANCIRETÃ,RS,0.468,0.532,5552,6314,11866
4308102,FELIZ,RS,0.254,0.746,2103,6167,8270
4306908,ENCRUZILHADA DO SUL,RS,0.535,0.465,7041,6116,13157
4318200,SÃO FRANCISCO DE PAULA,RS,0.439,0.561,4766,6091,10857
4309001,GIRUÁ,RS,0.389,0.611,3868,6066,9934
4319604,SÃO SEPÉ,RS,0.519,0.481,6531,6060,12591
4300109,AGUDO,RS,0.395,0.605,3949,6043,9992
4317905,SANTO CRISTO,RS,0.406,0.594,4124,6038,10162
4302709,BUTIÁ,RS,0.436,0.564,4631,5995,10626
4318408,SÃO JERÔNIMO,RS,0.444,0.556,4740,5942,10682
4319406,SÃO PEDRO DO SUL,RS,0.386,0.614,3684,5867,9551
4315503,RESTINGA SÊCA,RS,0.372,0.628,3457,5828,9285
4323804,XANGRI-LÁ,RS,0.257,0.743,2015,5827,7842
4307500,ESPUMOSO,RS,0.403,0.597,3851,5698,9549
4311205,JÚLIO DE CASTILHOS,RS,0.509,0.491,5786,5575,11361
4320701,SOBRADINHO,RS,0.366,0.634,3106,5372,8478
4302402,BOM RETIRO DO SUL,RS,0.285,0.715,2073,5191,7264
4318101,SÃO FRANCISCO DE ASSIS,RS,0.52,0.48,5544,5127,10671
4306205,CRUZEIRO DO SUL,RS,0.301,0.699,2147,4993,7140
4312906,NOVA BASSANO,RS,0.135,0.865,774,4980,5754
4301305,ARROIO GRANDE,RS,0.551,0.449,5903,4816,10719
4321667,TRÊS CACHOEIRAS,RS,0.221,0.779,1354,4784,6138
4301206,ARROIO DO TIGRE,RS,0.412,0.588,3256,4640,7896
4301404,ARVOREZINHA,RS,0.304,0.696,1987,4539,6526
4321105,TAPES,RS,0.441,0.559,3551,4502,8053
4306007,CRISSIUMAL,RS,0.435,0.565,3470,4501,7971
4317806,SANTO AUGUSTO,RS,0.459,0.541,3792,4472,8264
4315800,ROCA SALES,RS,0.257,0.743,1530,4430,5960
4314605,PIRATINI,RS,0.576,0.424,6022,4426,10448
4313656,PALMARES DO SUL,RS,0.383,0.617,2692,4337,7029
4301909,BARRA DO RIBEIRO,RS,0.394,0.606,2789,4285,7074
4304903,CASCA,RS,0.257,0.743,1481,4279,5760
4305207,CERRO LARGO,RS,0.454,0.546,3454,4149,7603
4311106,JAGUARI,RS,0.373,0.627,2465,4138,6603
4305454,CIDREIRA,RS,0.388,0.612,2554,4028,6582
4322301,TUPARENDI,RS,0.284,0.716,1589,4005,5594
4301107,ARROIO DOS RATOS,RS,0.463,0.537,3353,3883,7236
4305306,CHAPADA,RS,0.362,0.638,2173,3828,6001
4321436,TERRA DE AREIA,RS,0.292,0.708,1562,3790,5352
4320206,SEBERI,RS,0.441,0.559,2973,3773,6746
4306502,DOM FELICIANO,RS,0.506,0.494,3853,3758,7611
4314001,PARAÍ,RS,0.213,0.787,1018,3754,4772
4321402,TENENTE PORTELA,RS,0.504,0.496,3716,3660,7376
4312500,MOSTARDAS,RS,0.406,0.594,2483,3631,6114
4301057,ARROIO DO SAL,RS,0.267,0.733,1318,3619,4937
4301636,BALNEÁRIO PINHAL,RS,0.346,0.654,1910,3613,5523
4321006,TAPERA,RS,0.418,0.582,2588,3608,6196
4309050,GLORINHA,RS,0.24,0.76,1128,3577,4705
4312708,NONOAI,RS,0.495,0.505,3414,3479,6893
4310439,IPÊ,RS,0.184,0.816,777,3446,4223
4316709,SANTA BÁRBARA DO SUL,RS,0.358,0.642,1908,3425,5333
4305009,CATUÍPE,RS,0.403,0.597,2313,3425,5738
4322533,VALE DO SOL,RS,0.471,0.529,3046,3425,6471
4312476,MORRO REUTER,RS,0.182,0.818,755,3382,4137
4305801,CONSTANTINA,RS,0.456,0.544,2820,3364,6184
4316501,SALVADOR DO SUL,RS,0.225,0.775,960,3303,4263
4302303,BOM JESUS,RS,0.437,0.563,2538,3269,5807
4314704,PLANALTO,RS,0.426,0.574,2418,3260,5678
4304309,CÂNDIDO GODÓI,RS,0.298,0.702,1369,3228,4597
4300703,ANTA GORDA,RS,0.16,0.84,612,3203,3815
4304689,CAPELA DE SANTANA,RS,0.412,0.588,2237,3196,5433
4316758,SANTA CLARA DO SUL,RS,0.227,0.773,930,3159,4089
4306932,ENTRE-IJUÍS,RS,0.435,0.565,2402,3125,5527
4300208,AJURICABA,RS,0.344,0.656,1635,3116,4751
4318606,SÃO JOSÉ DO OURO,RS,0.292,0.708,1277,3100,4377
4315107,PORTO XAVIER,RS,0.477,0.523,2788,3062,5850
4301503,AUGUSTO PESTANA,RS,0.324,0.676,1467,3061,4528
4308706,GAURAMA,RS,0.272,0.728,1129,3015,4144
4302006,BARROS CASSAL,RS,0.491,0.509,2887,2991,5878
4301651,BARÃO,RS,0.245,0.755,963,2974,3937
4309902,IBIRAIARAS,RS,0.29,0.71,1213,2964,4177
4302204,BOA VISTA DO BURICÁ,RS,0.328,0.672,1441,2959,4400
4316451,SALTO DO JACUÍ,RS,0.507,0.493,3026,2939,5965
4320677,SINIMBU,RS,0.47,0.53,2590,2924,5514
4316956,SANTA MARIA DO HERVAL,RS,0.302,0.698,1248,2884,4132
4314506,PINHEIRO MACHADO,RS,0.586,0.414,4086,2882,6968
4305173,CERRO GRANDE DO SUL,RS,0.444,0.556,2296,2880,5176
4302907,CACEQUI,RS,0.536,0.464,3290,2850,6140
4300901,ARATIBA,RS,0.425,0.575,2090,2831,4921
4313953,PANTANO GRANDE,RS,0.522,0.478,3076,2822,5898
4316105,RONDA ALTA,RS,0.518,0.482,3002,2795,5797
4314159,PAVERAMA,RS,0.38,0.62,1703,2780,4483
4303806,CAMPINAS DO SUL,RS,0.242,0.758,873,2741,3614
4304713,CARAÁ,RS,0.371,0.629,1602,2713,4315
4314423,PICADA CAFÉ,RS,0.212,0.788,726,2703,3429
4322251,TUPANDI,RS,0.163,0.837,524,2700,3224
4308003,FAXINAL DO SOTURNO,RS,0.369,0.631,1579,2695,4274
4319109,SÃO MARTINHO,RS,0.29,0.71,1099,2695,3794
4310405,INDEPENDÊNCIA,RS,0.378,0.622,1636,2689,4325
4307559,ESTAÇÃO,RS,0.296,0.704,1130,2684,3814
4312252,MINAS DO LEÃO,RS,0.393,0.607,1735,2678,4413
4305702,CONDOR,RS,0.378,0.622,1627,2672,4299
4300877,ARARICÁ,RS,0.313,0.687,1218,2670,3888
4322541,VALE REAL,RS,0.269,0.731,976,2653,3629
4314027,PARAÍSO DO SUL,RS,0.377,0.623,1601,2650,4251
4301701,BARÃO DE COTEGIPE,RS,0.366,0.634,1528,2645,4173
4320552,SERTÃO SANTANA,RS,0.311,0.689,1191,2642,3833
4309506,GUARANI DAS MISSÕES,RS,0.449,0.551,2145,2633,4778
4312807,NOVA ARAÇÁ,RS,0.165,0.835,513,2605,3118
4312609,MUÇUM,RS,0.188,0.812,600,2590,3190
4303608,CAMBARÁ DO SUL,RS,0.285,0.715,1026,2580,3606
4322103,TUCUNDUVA,RS,0.308,0.692,1142,2570,3712
4320503,SERTÃO,RS,0.343,0.657,1328,2548,3876
4317707,SANTO ANTÔNIO DAS MISSÕES,RS,0.587,0.413,3609,2537,6146
4306056,CRISTAL,RS,0.442,0.558,1976,2494,4470
4319802,SÃO VICENTE DO SUL,RS,0.502,0.498,2500,2477,4977
4320305,SELBACH,RS,0.282,0.718,966,2465,3431
4313102,NOVA PALMA,RS,0.402,0.598,1651,2460,4111
4308805,GENERAL CÂMARA,RS,0.453,0.547,2027,2445,4472
4300505,ALPESTRE,RS,0.508,0.492,2519,2435,4954
4312450,MORRO REDONDO,RS,0.372,0.628,1434,2426,3860
4308300,FONTOURA XAVIER,RS,0.582,0.418,3354,2404,5758
4309555,HARMONIA,RS,0.234,0.766,721,2363,3084
4300307,ALECRIM,RS,0.448,0.552,1909,2355,4264
4318481,SÃO JOSÉ DO HORTÊNCIO,RS,0.179,0.821,511,2348,2859
4303707,CAMPINA DAS MISSÕES,RS,0.433,0.567,1785,2341,4126
4311775,MAQUINÉ,RS,0.445,0.555,1847,2300,4147
4319307,SÃO PAULO DAS MISSÕES,RS,0.45,0.55,1875,2293,4168
4305959,COTIPORÃ,RS,0.18,0.82,493,2252,2745
4320263,SEGREDO,RS,0.483,0.517,2097,2242,4339
4314076,PASSO DO SOBRADO,RS,0.426,0.574,1655,2231,3886
4316303,ROQUE GONZALES,RS,0.479,0.521,2042,2219,4261
4308409,FORMIGUEIRO,RS,0.462,0.538,1906,2216,4122
4302451,BOQUEIRÃO DO LEÃO,RS,0.478,0.522,2022,2210,4232
4323309,VILA FLORES,RS,0.172,0.828,456,2193,2649
4311700,MACHADINHO,RS,0.396,0.604,1429,2180,3609
4310504,IRAÍ,RS,0.496,0.504,2146,2177,4323
4305447,CHUVISCA,RS,0.332,0.668,1080,2172,3252
4315206,PUTINGA,RS,0.203,0.797,551,2159,2710
4317004,SANTANA DA BOA VISTA,RS,0.493,0.507,2097,2157,4254
4322905,VIADUTOS,RS,0.356,0.644,1193,2156,3349
4300646,AMETISTA DO SUL,RS,0.477,0.523,1956,2141,4097
4301750,BARÃO DO TRIUNFO,RS,0.37,0.63,1245,2118,3363
4316204,RONDINHA,RS,0.438,0.562,1644,2109,3753
4312203,MAXIMILIANO DE ALMEIDA,RS,0.298,0.702,895,2104,2999
4310306,ILÓPOLIS,RS,0.199,0.801,521,2097,2618
4309803,IBIAÇÁ,RS,0.308,0.692,930,2094,3024
4312385,MONTE BELO DO SUL,RS,0.132,0.868,318,2087,2405
4311155,JÓIA,RS,0.577,0.423,2809,2060,4869
4319158,SÃO MIGUEL DAS MISSÕES,RS,0.531,0.469,2328,2058,4386
4314035,PARECI NOVO,RS,0.177,0.823,441,2049,2490
4311627,LINDOLFO COLLOR,RS,0.411,0.589,1422,2036,3458
4312153,MATO LEITÃO,RS,0.323,0.677,968,2032,3000
4315156,PROGRESSO,RS,0.468,0.532,1784,2029,3813
4302659,BROCHIER,RS,0.325,0.675,967,2008,2975
4306734,DOUTOR MAURÍCIO CARDOSO,RS,0.381,0.619,1235,2005,3240
4304358,CANDIOTA,RS,0.637,0.363,3524,2005,5529
4309704,HUMAITÁ,RS,0.38,0.62,1227,2002,3229
4310538,ITAARA,RS,0.348,0.652,1066,1999,3065
4315354,QUINZE DE NOVEMBRO,RS,0.276,0.724,761,1999,2760
4323408,VILA MARIA,RS,0.294,0.706,820,1968,2788
4315909,RODEIO BONITO,RS,0.477,0.523,1777,1950,3727
4307302,ERVAL SECO,RS,0.538,0.462,2261,1940,4201
4305900,CORONEL BICACO,RS,0.528,0.472,2163,1935,4098
4313359,NOVA ROMA DO SUL,RS,0.201,0.799,485,1924,2409
4313037,NOVA ESPERANÇA DO SUL,RS,0.369,0.631,1122,1922,3044
4313805,PALMITINHO,RS,0.568,0.432,2525,1917,4442
4319356,SÃO PEDRO DA SERRA,RS,0.221,0.779,538,1901,2439
4315750,RIOZINHO,RS,0.354,0.646,1034,1883,2917
4301073,ARROIO DO PADRE,RS,0.175,0.825,399,1876,2275
4303400,CAIÇARA,RS,0.43,0.57,1401,1859,3260
4303202,CACIQUE DOBLE,RS,0.395,0.605,1206,1847,3053
4311759,MANOEL VIANA,RS,0.534,0.466,2117,1845,3962
4311908,MARCELINO RAMOS,RS,0.409,0.591,1273,1840,3113
4314209,PEDRO OSÓRIO,RS,0.616,0.384,2904,1811,4715
4306304,DAVID CANABARRO,RS,0.409,0.591,1249,1808,3057
4312054,MARQUES DE SOUZA,RS,0.334,0.666,902,1801,2703
4322327,TURUÇU,RS,0.295,0.705,747,1789,2536
4318424,SÃO JOÃO DA URTIGA,RS,0.441,0.559,1411,1787,3198
4303673,CAMPESTRE DA SERRA,RS,0.143,0.857,295,1774,2069
4313086,NOVA PÁDUA,RS,0.07,0.93,134,1770,1904
4313003,NOVA BRÉSCIA,RS,0.184,0.816,397,1766,2163
4305603,COLORADO,RS,0.273,0.727,659,1759,2418
4305124,CERRITO,RS,0.555,0.445,2186,1752,3938
4308458,FORTALEZA DOS VALOS,RS,0.4,0.6,1163,1744,2907
4300034,ACEGUÁ,RS,0.371,0.629,1025,1739,2764
4306452,DOIS LAJEADOS,RS,0.217,0.783,480,1737,2217
4311502,LAVRAS DO SUL,RS,0.551,0.449,2130,1736,3866
4305504,CIRÍACO,RS,0.385,0.615,1084,1733,2817
4315008,PORTO LUCENA,RS,0.446,0.554,1385,1719,3104
4320859,TABAÍ,RS,0.395,0.605,1122,1719,2841
4313391,NOVO CABRAIS,RS,0.38,0.62,1046,1707,2753
4321956,TRINDADE DO SUL,RS,0.538,0.462,1980,1703,3683
4321352,TAVARES,RS,0.451,0.549,1395,1701,3096
4305132,CERRO BRANCO,RS,0.393,0.607,1101,1698,2799
4312443,MORRINHOS DO SUL,RS,0.289,0.711,688,1689,2377
4300638,AMARAL FERRADOR,RS,0.491,0.509,1630,1687,3317
4321477,TIRADENTES DO SUL,RS,0.521,0.479,1823,1674,3497
4315404,REDENTORA,RS,0.634,0.366,2899,1670,4569
4311981,MARIANA PIMENTEL,RS,0.35,0.65,896,1663,2559
4300059,ÁGUA SANTA,RS,0.306,0.694,730,1659,2389
4301800,BARRACÃO,RS,0.47,0.53,1468,1656,3124
4304671,CAPIVARI DO SUL,RS,0.369,0.631,964,1651,2615
4302501,BOSSOROCA,RS,0.538,0.462,1894,1626,3520
4302253,BOA VISTA DO SUL,RS,0.197,0.803,396,1612,2008
4313425,NOVO MACHADO,RS,0.364,0.636,915,1600,2515
4320354,SENTINELA DO SUL,RS,0.46,0.54,1358,1595,2953
4300570,ALTO FELIZ,RS,0.202,0.798,403,1592,1995
4320602,SEVERIANO DE ALMEIDA,RS,0.416,0.584,1117,1570,2687
4312104,MATA,RS,0.477,0.523,1434,1570,3004
4315149,PRESIDENTE LUCENA,RS,0.206,0.794,406,1567,1973
4307864,FAGUNDES VARELA,RS,0.16,0.84,296,1559,1855
4310900,JACUTINGA,RS,0.335,0.665,785,1558,2343
4318440,SÃO JORGE,RS,0.208,0.792,407,1550,1957
4314548,PINTO BANDEIRA,RS,0.152,0.848,277,1548,1825
4323101,VICENTE DUTRA,RS,0.473,0.527,1381,1540,2921
4313607,PAIM FILHO,RS,0.476,0.524,1392,1534,2926
4307203,ERVAL GRANDE,RS,0.522,0.478,1674,1530,3204
4314308,PEJUÇARA,RS,0.35,0.65,821,1526,2347
4308078,FAZENDA VILANOVA,RS,0.361,0.639,861,1525,2386
4323770,WESTFÁLIA,RS,0.256,0.744,523,1520,2043
4322855,VESPASIANO CORRÊA,RS,0.115,0.885,198,1518,1716
4312757,NOVA ALVORADA,RS,0.282,0.718,591,1506,2097
4304002,CAMPO NOVO,RS,0.521,0.479,1629,1496,3125
4312377,MONTE ALEGRE DOS CAMPOS,RS,0.344,0.656,783,1496,2279
4320321,SENADOR SALGADO FILHO,RS,0.3,0.7,640,1495,2135
4301552,ÁUREA,RS,0.404,0.596,1008,1484,2492
4312138,MATO CASTELHANO,RS,0.274,0.726,560,1481,2041
4314068,PASSA SETE,RS,0.495,0.505,1439,1470,2909
4319703,SÃO VALENTIM,RS,0.382,0.618,907,1466,2373
4305405,CHIAPETTA,RS,0.432,0.568,1102,1450,2552
4319125,SÃO MARTINHO DA SERRA,RS,0.33,0.67,710,1442,2152
4300851,ARAMBARÉ,RS,0.378,0.622,874,1437,2311
4303301,CAIBATÉ,RS,0.532,0.468,1624,1426,3050
4310363,IMIGRANTE,RS,0.276,0.724,542,1420,1962
4309654,HULHA NEGRA,RS,0.606,0.394,2154,1399,3553
4309753,IBARAMA,RS,0.492,0.508,1353,1398,2751
4318622,SÃO JOSÉ DOS AUSENTES,RS,0.339,0.661,715,1392,2107
4311791,MARATÁ,RS,0.224,0.776,402,1390,1792
4319711,SÃO VALENTIM DO SUL,RS,0.177,0.823,297,1380,1677
4309951,IBIRAPUITÃ,RS,0.467,0.533,1204,1374,2578
4305587,COLINAS,RS,0.222,0.778,392,1370,1762
4313011,NOVA CANDELÁRIA,RS,0.311,0.689,616,1365,1981
4306700,DONA FRANCISCA,RS,0.41,0.59,948,1363,2311
4323200,VICTOR GRAEFF,RS,0.3,0.7,583,1360,1943
4316436,SALDANHA MARINHO,RS,0.339,0.661,693,1354,2047
4319752,SÃO VENDELINO,RS,0.228,0.772,397,1347,1744
4321634,TRÊS ARROIOS,RS,0.333,0.667,669,1337,2006
4314498,PINHEIRINHO DO VALE,RS,0.502,0.498,1334,1326,2660
4306551,DOM PEDRO DE ALCÂNTARA,RS,0.302,0.698,573,1326,1899
4312617,MUITOS CAPÕES,RS,0.243,0.757,426,1326,1752
4304697,CAPITÃO,RS,0.319,0.681,620,1322,1942
4311718,MAÇAMBARÁ,RS,0.492,0.508,1279,1322,2601
4318432,SÃO JOÃO DO POLÊSINE,RS,0.315,0.685,605,1316,1921
4315172,PROTÁSIO ALVES,RS,0.147,0.853,227,1315,1542
4308433,FORQUETINHA,RS,0.299,0.701,560,1312,1872
4314472,PINHAL GRANDE,RS,0.512,0.488,1373,1311,2684
4300455,ALEGRIA,RS,0.482,0.518,1215,1308,2523
4321857,TRÊS PALMEIRAS,RS,0.556,0.444,1637,1308,2945
4305871,CORONEL BARROS,RS,0.339,0.661,667,1298,1965
4314779,PONTÃO,RS,0.5,0.5,1296,1297,2593
4303558,CAMARGO,RS,0.302,0.698,561,1295,1856
4312302,MIRAGUAÍ,RS,0.577,0.423,1761,1292,3053
4305850,COQUEIROS DO SUL,RS,0.293,0.707,535,1290,1825
4304952,CASEIROS,RS,0.378,0.622,783,1287,2070
4307054,ERNESTINA,RS,0.399,0.601,853,1284,2137
4318051,SÃO DOMINGOS DO SUL,RS,0.364,0.636,729,1276,2005
4311601,LIBERATO SALZANO,RS,0.611,0.389,2003,1276,3279
4321493,TOROPI,RS,0.365,0.635,730,1271,2001
4316477,SALVADOR DAS MISSÕES,RS,0.37,0.63,746,1271,2017
4323754,VITÓRIA DAS MISSÕES,RS,0.512,0.488,1332,1269,2601
4302584,BOZANO,RS,0.33,0.67,622,1264,1886
4301958,BARRA FUNDA,RS,0.383,0.617,785,1263,2048
4304101,CAMPOS BORGES,RS,0.461,0.539,1078,1262,2340
4323358,VILA LÂNGARO,RS,0.261,0.739,445,1261,1706
4307815,ESTRELA VELHA,RS,0.43,0.57,949,1259,2208
4311122,JAQUIRANA,RS,0.441,0.559,991,1256,2247
4307104,HERVAL,RS,0.655,0.345,2379,1252,3631
4313490,NOVO BARREIRO,RS,0.551,0.449,1518,1238,2756
4323457,VILA NOVA DO SUL,RS,0.499,0.501,1232,1235,2467
4310652,ITATI,RS,0.393,0.607,793,1223,2016
4310462,IPIRANGA DO SUL,RS,0.219,0.781,340,1209,1549
4321832,TRÊS FORQUILHAS,RS,0.394,0.606,785,1205,1990
4322525,VALE VERDE,RS,0.447,0.553,973,1203,2176
4311254,LAGOÃO,RS,0.661,0.339,2343,1202,3545
4321469,TIO HUGO,RS,0.364,0.636,679,1188,1867
4319208,SÃO NICOLAU,RS,0.587,0.413,1688,1186,2874
4319372,SÃO PEDRO DO BUTIÁ,RS,0.381,0.619,727,1181,1908
4318499,SÃO JOSÉ DO INHACORÁ,RS,0.346,0.654,624,1178,1802
4305439,CHUÍ,RS,0.566,0.434,1523,1168,2691
4306379,DILERMANDO DE AGUIAR,RS,0.425,0.575,865,1168,2033
4312427,MORMAÇO,RS,0.399,0.601,772,1165,1937
4305975,COXILHA,RS,0.422,0.578,847,1159,2006
4306973,EREBANGO,RS,0.4,0.6,765,1149,1914
4317756,SANTO ANTÔNIO DO PLANALTO,RS,0.262,0.738,406,1145,1551
4314753,POÇO DAS ANTAS,RS,0.257,0.743,396,1143,1539
4310850,JABOTICABA,RS,0.508,0.492,1165,1128,2293
4306759,DOUTOR RICARDO,RS,0.256,0.744,388,1126,1514
4315057,PORTO MAUÁ,RS,0.321,0.679,531,1125,1656
4315453,RELVADO,RS,0.236,0.764,347,1123,1470
4306130,CRUZALTENSE,RS,0.319,0.681,524,1121,1645
4318614,SÃO JOSÉ DO SUL,RS,0.235,0.765,340,1108,1448
4307401,ESMERALDA,RS,0.415,0.585,784,1106,1890
4322343,UBIRETAMA,RS,0.297,0.703,462,1092,1554
4305116,CENTENÁRIO,RS,0.494,0.506,1066,1091,2157
4320651,SILVEIRA MARTINS,RS,0.366,0.634,627,1087,1714
4306320,DERRUBADAS,RS,0.472,0.528,960,1076,2036
4302220,BOA VISTA DO CADEADO,RS,0.294,0.706,447,1073,1520
4314134,PAULO BENTO,RS,0.311,0.689,483,1068,1551
4316972,SANTA MARGARIDA DO SUL,RS,0.43,0.57,802,1064,1866
4307831,EUGÊNIO DE CASTRO,RS,0.391,0.609,679,1057,1736
4311734,MAMPITUBA,RS,0.488,0.512,1007,1055,2062
4321329,TAQUARUÇU DO SUL,RS,0.481,0.519,966,1042,2008
4322558,VANINI,RS,0.297,0.703,439,1041,1480
4317954,SANTO EXPEDITO DO SUL,RS,0.387,0.613,649,1030,1679
4322376,UNISTALDA,RS,0.444,0.556,816,1023,1839
4320230,SEDE NOVA,RS,0.44,0.56,796,1015,1811
4306957,ENTRE RIOS DO SUL,RS,0.473,0.527,910,1014,1924
4302238,BOA VISTA DO INCRA,RS,0.385,0.615,633,1012,1645
4317251,SANTA TEREZA,RS,0.224,0.776,289,1004,1293
4307450,ESPERANÇA DO SUL,RS,0.545,0.455,1196,1000,2196
4313334,NOVA RAMADA,RS,0.395,0.605,649,996,1645
4310702,ITATIBA DO SUL,RS,0.627,0.373,1670,995,2665
4301875,BARRA DO QUARAÍ,RS,0.492,0.508,963,994,1957
4323606,VISTA ALEGRE DO PRATA,RS,0.172,0.828,206,994,1200
4308052,FAXINALZINHO,RS,0.422,0.578,725,991,1716
4312955,NOVA BOA VISTA,RS,0.353,0.647,538,987,1525
4316733,SANTA CECÍLIA DO SUL,RS,0.299,0.701,419,982,1401
4323705,VISTA GAÚCHA,RS,0.476,0.524,886,974,1860
4309159,GRAMADO XAVIER,RS,0.568,0.432,1271,965,2236
4312674,NICOLAU VERGUEIRO,RS,0.328,0.672,467,955,1422
4322350,UNIÃO DA SERRA,RS,0.193,0.807,227,950,1177
4314787,PONTE PRETA,RS,0.326,0.674,457,946,1403
4304655,CAPÃO DO CIPÓ,RS,0.537,0.463,1094,943,2037
4305934,CORONEL PILAR,RS,0.193,0.807,225,942,1167
4305371,CHARRUA,RS,0.464,0.536,813,941,1754
4321626,TRAVESSEIRO,RS,0.406,0.594,641,938,1579
4314464,PINHAL DA SERRA,RS,0.429,0.571,701,934,1635
4300471,ALMIRANTE TAMANDARÉ DO SUL,RS,0.383,0.617,573,923,1496
4311270,LAGOA DOS TRÊS CANTOS,RS,0.246,0.754,300,918,1218
4323507,VISTA ALEGRE,RS,0.544,0.456,1089,911,2000
4306353,DEZESSEIS DE NOVEMBRO,RS,0.509,0.491,932,899,1831
4309258,GUABIJU,RS,0.198,0.802,222,897,1119
4311130,JARI,RS,0.586,0.414,1268,896,2164
4312351,MONTAURI,RS,0.23,0.77,268,896,1164
4308854,GENTIL,RS,0.256,0.744,307,891,1198
4314456,PINHAL,RS,0.46,0.54,758,891,1649
4310553,ITACURUBI,RS,0.527,0.473,984,882,1866
4322152,TUNAS,RS,0.652,0.348,1652,880,2532
4302600,BRAGA,RS,0.577,0.423,1190,871,2061
4311239,LAGOA BONITA DO SUL,RS,0.523,0.477,942,860,1802
4320453,SÉRIO,RS,0.458,0.542,706,834,1540
4305835,COQUEIRO BAIXO,RS,0.198,0.802,204,826,1030
4311643,LINHA NOVA,RS,0.257,0.743,283,819,1102
4317558,SANTO ANTÔNIO DO PALMA,RS,0.455,0.545,676,810,1486
4310751,IVORÁ,RS,0.42,0.58,582,805,1387
4302378,BOM PROGRESSO,RS,0.499,0.501,800,804,1604
4301859,BARRA DO GUARITA,RS,0.554,0.446,998,804,1802
4310579,ITAPUCA,RS,0.4,0.6,537,804,1341
4315958,ROLADOR,RS,0.522,0.478,871,796,1667
4304622,CAPÃO BONITO DO SUL,RS,0.469,0.531,694,787,1481
4315552,RIO DOS ÍNDIOS,RS,0.633,0.367,1349,782,2131
4300554,ALTO ALEGRE,RS,0.432,0.568,586,772,1358
4316428,SAGRADA FAMÍLIA,RS,0.524,0.476,842,766,1608
4306072,CRISTAL DO SUL,RS,0.603,0.397,1149,758,1907
4312005,MARIANO MORO,RS,0.498,0.502,751,756,1507
4315321,QUEVEDOS,RS,0.533,0.467,851,747,1598
4312625,MULITERNO,RS,0.497,0.503,731,741,1472
4320578,SETE DE SETEMBRO,RS,0.47,0.53,655,738,1393
4308250,FLORIANO PEIXOTO,RS,0.487,0.513,699,735,1434
4315313,QUATRO IRMÃOS,RS,0.391,0.609,466,726,1192
4315131,POUSO NOVO,RS,0.403,0.597,486,721,1207
4315073,PORTO VERA CRUZ,RS,0.445,0.555,576,718,1294
4318465,SÃO JOSÉ DO HERVAL,RS,0.499,0.501,706,710,1416
4309571,HERVEIRAS,RS,0.639,0.361,1258,710,1968
4314555,PIRAPÓ,RS,0.549,0.451,862,709,1571
4300661,ANDRÉ DA ROCHA,RS,0.25,0.75,236,709,945
4310413,INHACORÁ,RS,0.523,0.477,769,701,1470
4308656,GARRUCHOS,RS,0.623,0.377,1157,700,1857
4301925,BARRA DO RIO AZUL,RS,0.507,0.493,704,684,1388
4302154,BOA VISTA DAS MISSÕES,RS,0.524,0.476,753,683,1436
4306429,DOIS IRMÃOS DAS MISSÕES,RS,0.546,0.454,809,673,1482
4312179,MATO QUEIMADO,RS,0.465,0.535,569,655,1224
4322186,TUPANCI DO SUL,RS,0.336,0.664,329,650,979
4304614,CANUDOS DO VALE,RS,0.542,0.458,766,646,1412
4319737,SÃO VALÉRIO DO SUL,RS,0.596,0.404,922,626,1548
4318457,SÃO JOSÉ DAS MISSÕES,RS,0.611,0.389,973,620,1593
4310876,JACUIZINHO,RS,0.611,0.389,958,611,1569
4309126,GRAMADO DOS LOUREIROS,RS,0.61,0.39,954,609,1563
4313441,NOVO TIRADENTES,RS,0.551,0.449,743,606,1349
4313466,NOVO XINGU,RS,0.517,0.483,640,598,1238
4305157,CERRO GRANDE,RS,0.649,0.351,1072,581,1653
4319364,SÃO PEDRO DAS MISSÕES,RS,0.538,0.462,639,549,1188
4304853,CARLOS GOMES,RS,0.521,0.479,590,542,1132
4302055,BENJAMIN CONSTANT DO SUL,RS,0.652,0.348,971,518,1489
4311429,LAJEADO DO BUGRE,RS,0.622,0.378,839,510,1349
4314175,PEDRAS ALTAS,RS,0.656,0.344,912,478,1390
4306924,ENGENHO VELHO,RS,0.536,0.464,478,413,891
1100205,PORTO VELHO,RO,0.311,0.689,74847,166145,240992
1100122,JI-PARANÁ,RO,0.226,0.774,14174,48520,62694
1100023,ARIQUEMES,RO,0.192,0.808,8862,37325,46187
1100304,VILHENA,RO,0.187,0.813,8396,36531,44927
1100049,CACOAL,RO,0.219,0.781,10091,35962,46053
1100288,ROLIM DE MOURA,RO,0.24,0.76,6779,21429,28208
1100114,JARU,RO,0.221,0.779,5627,19879,25506
1100189,PIMENTA BUENO,RO,0.222,0.778,4284,15045,19329
1100155,OURO PRETO DO OESTE,RO,0.254,0.746,4696,13779,18475
1100106,GUAJARÁ-MIRIM,RO,0.313,0.687,5844,12838,18682
1100098,ESPIGÃO D'OESTE,RO,0.268,0.732,4593,12536,17129
1100452,BURITIS,RO,0.226,0.774,3417,11682,15099
1100130,MACHADINHO D'OESTE,RO,0.328,0.672,4633,9513,14146
1100338,NOVA MAMORÉ,RO,0.245,0.755,2795,8634,11429
1100015,ALTA FLORESTA D'OESTE,RO,0.306,0.694,3763,8524,12287
1100254,PRESIDENTE MÉDICI,RO,0.277,0.723,2978,7768,10746
1100056,CEREJEIRAS,RO,0.186,0.814,1745,7656,9401
1100320,SÃO MIGUEL DO GUAPORÉ,RO,0.329,0.671,3616,7386,11002
1100809,CANDEIAS DO JAMARI,RO,0.388,0.612,4507,7104,11611
1100064,COLORADO DO OESTE,RO,0.26,0.74,2441,6932,9373
1100148,NOVA BRASILÂNDIA D'OESTE,RO,0.293,0.707,2790,6723,9513
1100403,ALTO PARAÍSO,RO,0.284,0.716,2257,5701,7958
1101492,SÃO FRANCISCO DO GUAPORÉ,RO,0.328,0.672,2505,5134,7639
1100940,CUJUBIM,RO,0.263,0.737,1775,4975,6750
1101401,MONTE NEGRO,RO,0.276,0.724,1811,4750,6561
1100346,ALVORADA D'OESTE,RO,0.373,0.627,2817,4729,7546
1101708,URUPÁ,RO,0.34,0.66,2051,3985,6036
1101500,SERINGUEIRAS,RO,0.37,0.63,2252,3832,6084
1100379,ALTO ALEGRE DOS PARECIS,RO,0.372,0.628,2244,3790,6034
1100700,CAMPO NOVO DE RONDÔNIA,RO,0.332,0.668,1789,3595,5384
1101302,MIRANTE DA SERRA,RO,0.379,0.621,2158,3543,5701
1101609,THEOBROMA,RO,0.338,0.662,1759,3441,5200
1100080,COSTA MARQUES,RO,0.412,0.588,2329,3320,5649
1100502,NOVO HORIZONTE DO OESTE,RO,0.388,0.612,1995,3152,5147
1101005,GOVERNADOR JORGE TEIXEIRA,RO,0.321,0.679,1462,3098,4560
1100924,CHUPINGUAIA,RO,0.33,0.67,1504,3057,4561
1100296,SANTA LUZIA D'OESTE,RO,0.348,0.652,1632,3053,4685
1101203,MINISTRO ANDREAZZA,RO,0.348,0.652,1518,2840,4358
1101757,VALE DO ANARI,RO,0.324,0.676,1309,2732,4041
1101807,VALE DO PARAÍSO,RO,0.35,0.65,1407,2615,4022
1100072,CORUMBIARA,RO,0.384,0.616,1613,2585,4198
1101104,ITAPUÃ DO OESTE,RO,0.375,0.625,1534,2556,4090
1101484,SÃO FELIPE D'OESTE,RO,0.297,0.703,964,2282,3246
1100031,CABIXI,RO,0.341,0.659,1110,2142,3252
1101435,NOVA UNIÃO,RO,0.446,0.554,1697,2106,3803
1100601,CACAULÂNDIA,RO,0.261,0.739,694,1967,2661
1101559,TEIXEIRÓPOLIS,RO,0.355,0.645,996,1810,2806
1100262,RIO CRESPO,RO,0.272,0.728,539,1446,1985
1101476,PRIMAVERA DE RONDÔNIA,RO,0.271,0.729,529,1423,1952
1101450,PARECIS,RO,0.412,0.588,912,1301,2213
1100908,CASTANHEIRAS,RO,0.412,0.588,875,1250,2125
1101468,PIMENTEIRAS DO OESTE,RO,0.336,0.664,428,847,1275
1400100,BOA VISTA,RR,0.214,0.786,36021,132361,168382
1400472,RORAINÓPOLIS,RR,0.341,0.659,4455,8597,13052
1400308,MUCAJAÍ,RR,0.316,0.684,2641,5715,8356
1400209,CARACARAÍ,RR,0.366,0.634,3248,5631,8879
1400175,CANTÁ,RR,0.416,0.584,3556,4991,8547
1400050,ALTO ALEGRE,RR,0.398,0.602,2877,4354,7231
1400159,BONFIM,RR,0.425,0.575,2797,3778,6575
1400233,CAROEBE,RR,0.293,0.707,1296,3120,4416
1400456,PACARAIMA,RR,0.516,0.484,3028,2841,5869
1400027,AMAJARI,RR,0.411,0.589,1844,2648,4492
1400282,IRACEMA,RR,0.394,0.606,1450,2234,3684
1400605,SÃO LUIZ,RR,0.351,0.649,1205,2230,3435
1400506,SÃO JOÃO DA BALIZA,RR,0.373,0.627,1217,2048,3265
1400407,NORMANDIA,RR,0.662,0.338,3594,1833,5427
1400704,UIRAMUTÃ,RR,0.804,0.196,3643,887,4530
4209102,JOINVILLE,SC,0.168,0.832,53088,262556,315644
4205407,FLORIANÓPOLIS,SC,0.351,0.649,92063,169952,262015
4202404,BLUMENAU,SC,0.16,0.84,31090,162622,193712
4216602,SÃO JOSÉ,SC,0.268,0.732,34859,95393,130252
4208203,ITAJAÍ,SC,0.186,0.814,20584,89866,110450
4204608,CRICIÚMA,SC,0.181,0.819,19694,89133,108827
4208906,JARAGUÁ DO SUL,SC,0.168,0.832,15558,77241,92799
4204202,CHAPECÓ,SC,0.355,0.645,40310,73156,113466
4211900,PALHOÇA,SC,0.243,0.757,22914,71369,94283
4209300,LAGES,SC,0.262,0.738,23459,66171,89630
4202909,BRUSQUE,SC,0.132,0.868,9095,59820,68915
4202008,BALNEÁRIO CAMBORIÚ,SC,0.18,0.82,11902,54202,66104
4218707,TUBARÃO,SC,0.166,0.834,9784,49205,58989
4215802,SÃO BENTO DO SUL,SC,0.149,0.851,7048,40247,47295
4204301,CONCÓRDIA,SC,0.246,0.754,10815,33063,43878
4214805,RIO DO SUL,SC,0.171,0.829,6311,30687,36998
4203204,CAMBORIÚ,SC,0.216,0.784,8233,29889,38122
4207502,INDAIAL,SC,0.135,0.865,4635,29606,34241
4205902,GASPAR,SC,0.175,0.825,6259,29511,35770
4201406,ARARANGUÁ,SC,0.221,0.779,8171,28744,36915
4211306,NAVEGANTES,SC,0.216,0.784,7774,28223,35997
4202305,BIGUAÇU,SC,0.248,0.752,9277,28061,37338
4210100,MAFRA,SC,0.192,0.808,6104,25692,31796
4208302,ITAPEMA,SC,0.17,0.83,5244,25591,30835
4207007,IÇARA,SC,0.173,0.827,5363,25561,30924
4203006,CAÇADOR,SC,0.331,0.669,12277,24760,37037
4203808,CANOINHAS,SC,0.246,0.754,7699,23636,31335
4218202,TIMBÓ,SC,0.104,0.896,2615,22582,25197
4219309,VIDEIRA,SC,0.225,0.775,6117,21129,27246
4216206,SÃO FRANCISCO DO SUL,SC,0.217,0.783,5555,20054,25609
4215000,RIO NEGRINHO,SC,0.172,0.828,3950,19056,23006
4206504,GUARAMIRIM,SC,0.189,0.811,4341,18653,22994
4209409,LAGUNA,SC,0.28,0.72,7011,18029,25040
4207304,IMBITUBA,SC,0.305,0.695,7633,17413,25046
4213203,POMERODE,SC,0.128,0.872,2448,16620,19068
4202800,BRAÇO DO NORTE,SC,0.129,0.871,2413,16337,18750
4218004,TIJUCAS,SC,0.189,0.811,3770,16227,19997
4219507,XANXERÊ,SC,0.395,0.605,10315,15782,26097
4217204,SÃO MIGUEL DO OESTE,SC,0.314,0.686,7091,15470,22561
4204806,CURITIBANOS,SC,0.326,0.674,6912,14273,21185
4216305,SÃO JOÃO BATISTA,SC,0.128,0.872,2090,14229,16319
4205506,FRAIBURGO,SC,0.314,0.686,6329,13838,20167
4213609,PORTO UNIÃO,SC,0.252,0.748,4641,13798,18439
4209003,JOAÇABA,SC,0.213,0.787,3570,13168,16738
4202107,BARRA VELHA,SC,0.181,0.819,2909,13122,16031
4203600,CAMPOS NOVOS,SC,0.312,0.688,5899,13034,18933
4211702,ORLEANS,SC,0.135,0.865,1972,12589,14561
4217709,SOMBRIO,SC,0.22,0.78,3544,12546,16090
4205456,FORQUILHINHA,SC,0.182,0.818,2743,12367,15110
4208500,ITUPORANGA,SC,0.161,0.839,2340,12231,14571
4212502,PENHA,SC,0.16,0.84,2280,11931,14211
4219002,URUSSANGA,SC,0.132,0.868,1707,11206,12913
4206306,GUABIRUBA,SC,0.128,0.872,1610,11000,12610
4219705,XAXIM,SC,0.346,0.654,5823,10995,16818
4201307,ARAQUARI,SC,0.233,0.767,3277,10771,14048
4215703,SANTO AMARO DA IMPERATRIZ,SC,0.239,0.761,3345,10643,13988
4210506,MARAVILHA,SC,0.281,0.719,4154,10625,14779
4203956,CAPIVARI DE BAIXO,SC,0.256,0.744,3300,9604,12904
4208104,ITAIÓPOLIS,SC,0.227,0.773,2749,9357,12106
4206702,HERVAL D'OESTE,SC,0.263,0.737,3276,9201,12477
4217808,TAIÓ,SC,0.16,0.84,1752,9199,10951
4205704,GAROPABA,SC,0.303,0.697,3973,9143,13116
4206009,GOVERNADOR CELSO RAMOS,SC,0.147,0.853,1568,9103,10671
4216503,SÃO JOAQUIM,SC,0.336,0.664,4571,9052,13623
4211207,MORRO DA FUMAÇA,SC,0.135,0.865,1410,9012,10422
4212809,BALNEÁRIO PIÇARRAS,SC,0.184,0.816,2029,8993,11022
4217402,SCHROEDER,SC,0.166,0.834,1777,8937,10714
4216909,SÃO LOURENÇO DO OESTE,SC,0.35,0.65,4800,8899,13699
4204251,COCAL DO SUL,SC,0.152,0.848,1594,8892,10486
4203907,CAPINZAL,SC,0.302,0.698,3825,8851,12676
4206900,IBIRAMA,SC,0.172,0.828,1835,8815,10650
4208807,JAGUARUNA,SC,0.194,0.806,2115,8771,10886
4210605,MASSARANDUBA,SC,0.132,0.868,1321,8665,9986
4214003,PRESIDENTE GETÚLIO,SC,0.162,0.838,1614,8350,9964
4202453,BOMBINHAS,SC,0.194,0.806,1974,8189,10163
4213500,PORTO BELO,SC,0.18,0.82,1794,8176,9970
4211603,NOVA VENEZA,SC,0.157,0.843,1482,7975,9457
4204509,CORUPÁ,SC,0.159,0.841,1454,7716,9170
4209607,LAURO MÜLLER,SC,0.19,0.81,1760,7493,9253
4208450,ITAPOÁ,SC,0.23,0.77,2225,7459,9684
4211751,OTACÍLIO COSTA,SC,0.255,0.745,2480,7238,9718
4218301,TRÊS BARRAS,SC,0.3,0.7,3096,7237,10333
4211504,NOVA TRENTO,SC,0.129,0.871,1069,7232,8301
4213708,POUSO REDONDO,SC,0.178,0.822,1556,7168,8724
4212205,PAPANDUVA,SC,0.367,0.633,4042,6961,11003
4207106,ILHOTA,SC,0.158,0.842,1301,6950,8251
4212908,PINHALZINHO,SC,0.383,0.617,4312,6942,11254
4208401,ITAPIRANGA,SC,0.275,0.725,2624,6907,9531
4218806,TURVO,SC,0.127,0.873,986,6763,7749
4217600,SIDERÓPOLIS,SC,0.187,0.813,1536,6691,8227
4212106,PALMITOS,SC,0.306,0.694,2901,6582,9483
4217501,SEARA,SC,0.39,0.61,4122,6454,10576
4205803,GARUVA,SC,0.221,0.779,1834,6449,8283
4215109,RODEIO,SC,0.122,0.878,891,6390,7281
4210001,LUIZ ALVES,SC,0.128,0.872,924,6275,7199
4216701,SÃO JOSÉ DO CEDRO,SC,0.284,0.716,2464,6222,8686
4217006,SÃO LUDGERO,SC,0.132,0.868,940,6161,7101
4203303,CAMPO ALEGRE,SC,0.146,0.854,1048,6146,7194
4220000,BALNEÁRIO RINCÃO,SC,0.251,0.749,1956,5842,7798
4206207,GRAVATAL,SC,0.163,0.837,1128,5801,6929
4204707,CUNHA PORÃ,SC,0.169,0.831,1177,5790,6967
4202206,BENEDITO NOVO,SC,0.115,0.885,736,5685,6421
4214706,RIO DOS CEDROS,SC,0.13,0.87,848,5681,6529
4208708,JACINTO MACHADO,SC,0.192,0.808,1336,5613,6949
4201208,ANTÔNIO CARLOS,SC,0.129,0.871,833,5611,6444
4215455,SANGÃO,SC,0.148,0.852,955,5487,6442
4215505,SANTA CECÍLIA,SC,0.372,0.628,3233,5461,8694
4203709,CANELINHA,SC,0.173,0.827,1133,5434,6567
4204558,CORREIA PINTO,SC,0.388,0.612,3433,5419,8852
4209904,LONTRAS,SC,0.167,0.833,1067,5331,6398
4201950,BALNEÁRIO ARROIO DO SILVA,SC,0.277,0.723,1979,5177,7156
4202057,BALNEÁRIO BARRA DO SUL,SC,0.224,0.776,1488,5164,6652
4200200,AGROLÂNDIA,SC,0.185,0.815,1151,5056,6207
4201257,APIÚNA,SC,0.182,0.818,1118,5028,6146
4200101,ABELARDO LUZ,SC,0.451,0.549,4121,5023,9144
4200705,ALFREDO WAGNER,SC,0.243,0.757,1479,4600,6079
4218400,TREZE DE MAIO,SC,0.108,0.892,543,4503,5046
4218905,URUBICI,SC,0.234,0.766,1366,4473,5839
4202073,BALNEÁRIO GAIVOTA,SC,0.264,0.736,1590,4422,6012
4205001,DIONÍSIO CERQUEIRA,SC,0.46,0.54,3745,4399,8144
4201505,ARMAZÉM,SC,0.169,0.831,875,4299,5174
4207205,IMARUÍ,SC,0.358,0.642,2386,4288,6674
4201703,ASCURRA,SC,0.106,0.894,506,4257,4763
4206405,GUARACIABA,SC,0.393,0.607,2728,4207,6935
4215653,SANTA ROSA DO SUL,SC,0.225,0.775,1212,4171,5383
4210803,MELEIRO,SC,0.144,0.856,686,4077,4763
4212650,PESCARIA BRAVA,SC,0.289,0.711,1646,4051,5697
4216008,SÃO CARLOS,SC,0.378,0.622,2443,4026,6469
4204004,CATANDUVAS,SC,0.336,0.664,1992,3945,5937
4207908,IRINEÓPOLIS,SC,0.358,0.642,2149,3861,6010
4217907,TANGARÁ,SC,0.253,0.747,1301,3851,5152
4217303,SAUDADES,SC,0.373,0.627,2276,3832,6108
4204400,CORONEL FREITAS,SC,0.394,0.606,2483,3824,6307
4209508,LAURENTINO,SC,0.163,0.837,744,3812,4556
4216404,SÃO JOÃO DO SUL,SC,0.218,0.782,1051,3767,4818
4210407,MARACAJÁ,SC,0.23,0.77,1113,3728,4841
4206108,GRÃO PARÁ,SC,0.16,0.84,709,3723,4432
4207650,IPORÃ DO OESTE,SC,0.333,0.667,1841,3692,5533
4218509,TREZE TÍLIAS,SC,0.197,0.803,895,3657,4552
4215679,SANTA TEREZINHA,SC,0.284,0.716,1445,3643,5088
4215307,SALETE,SC,0.21,0.79,966,3634,4600
4200606,ÁGUAS MORNAS,SC,0.201,0.799,906,3608,4514
4214607,RIO DO OESTE,SC,0.24,0.76,1129,3568,4697
4212304,PAULO LOPES,SC,0.257,0.743,1221,3535,4756
4211009,MONDAÍ,SC,0.384,0.616,2205,3534,5739
4212700,PETROLÂNDIA,SC,0.18,0.82,762,3466,4228
4218608,TROMBUDO CENTRAL,SC,0.166,0.834,681,3431,4112
4204905,DESCANSO,SC,0.38,0.62,2077,3389,5466
4207809,IRANI,SC,0.387,0.613,2139,3387,5526
4201901,AURORA,SC,0.17,0.83,693,3374,4067
4219200,VIDAL RAMOS,SC,0.244,0.756,1089,3371,4460
4210035,LUZERNA,SC,0.158,0.842,630,3367,3997
4211801,OURO,SC,0.257,0.743,1154,3340,4494
4216107,SÃO DOMINGOS,SC,0.426,0.574,2474,3339,5813
4214201,QUILOMBO,SC,0.49,0.51,3204,3337,6541
4214904,RIO FORTUNA,SC,0.104,0.896,380,3283,3663
4202602,BOM RETIRO,SC,0.321,0.679,1518,3216,4734
4205308,FAXINAL DOS GUEDES,SC,0.512,0.488,3366,3212,6578
4214508,RIO DO CAMPO,SC,0.22,0.78,906,3207,4113
4216255,SÃO JOÃO DO OESTE,SC,0.212,0.788,857,3193,4050
4212254,PASSO DE TORRES,SC,0.279,0.721,1217,3151,4368
4211108,MONTE CASTELO,SC,0.366,0.634,1810,3140,4950
4202701,BOTUVERÁ,SC,0.127,0.873,449,3087,3536
4213401,PONTE SERRADA,SC,0.5,0.5,2978,2976,5954
4214409,RIO DAS ANTAS,SC,0.246,0.754,957,2930,3887
4200309,AGRONÔMICA,SC,0.128,0.872,430,2928,3358
4207403,IMBUIA,SC,0.234,0.766,891,2923,3814
4200408,ÁGUA DOCE,SC,0.284,0.716,1158,2921,4079
4213807,PRAIA GRANDE,SC,0.363,0.637,1648,2890,4538
4210308,MAJOR VIEIRA,SC,0.353,0.647,1537,2812,4349
4213104,PIRATUBA,SC,0.279,0.721,1061,2740,3801
4218103,TIMBÉ DO SUL,SC,0.215,0.785,746,2730,3476
4212403,PEDRAS GRANDES,SC,0.122,0.878,374,2685,3059
4218350,TREVISO,SC,0.158,0.842,502,2680,3182
4207700,IPUMIRIM,SC,0.422,0.578,1955,2673,4628
4209706,LEBON RÉGIS,SC,0.57,0.43,3516,2656,6172
4211058,MONTE CARLO,SC,0.489,0.511,2522,2639,5161
4203105,CAIBI,SC,0.308,0.692,1163,2607,3770
4201000,ANITA GARIBALDI,SC,0.489,0.511,2473,2584,5057
4217253,SÃO PEDRO DE ALCÂNTARA,SC,0.171,0.829,528,2561,3089
4202131,BELA VISTA DO TOLDO,SC,0.346,0.654,1324,2508,3832
4200903,ANGELINA,SC,0.372,0.628,1466,2473,3939
4216800,SÃO JOSÉ DO CERRITO,SC,0.543,0.457,2903,2441,5344
4208005,ITÁ,SC,0.443,0.557,1939,2437,4376
4203402,CAMPO BELO DO SUL,SC,0.45,0.55,1989,2435,4424
4203501,CAMPO ERÊ,SC,0.543,0.457,2871,2420,5291
4218756,TUNÁPOLIS,SC,0.235,0.765,737,2398,3135
4217105,SÃO MARTINHO,SC,0.124,0.876,332,2355,2687
4205209,ERVAL VELHO,SC,0.251,0.749,777,2316,3093
4216354,SÃO JOÃO DO ITAPERIÚ,SC,0.134,0.866,357,2309,2666
4208609,JABORÁ,SC,0.253,0.747,745,2198,2943
4219358,VITOR MEIRELES,SC,0.311,0.689,985,2181,3166
4202859,BRAÇO DO TROMBUDO,SC,0.123,0.877,303,2166,2469
4209151,JOSÉ BOITEUX,SC,0.322,0.678,986,2080,3066
4200804,ANCHIETA,SC,0.47,0.53,1801,2027,3828
4211256,MORRO GRANDE,SC,0.135,0.865,316,2018,2334
4219176,VARGEM BONITA,SC,0.351,0.649,1083,2003,3086
4205159,DOUTOR PEDRINHO,SC,0.137,0.863,317,1998,2315
4204350,CORDILHEIRA ALTA,SC,0.361,0.639,1120,1980,3100
4207759,IRACEMINHA,SC,0.303,0.697,857,1970,2827
4206603,GUARUJÁ DO SUL,SC,0.359,0.641,1100,1960,3060
4206652,GUATAMBÚ,SC,0.542,0.458,2317,1959,4276
4201273,ARABUTÃ,SC,0.332,0.668,967,1943,2910
4201802,ATALANTA,SC,0.164,0.836,379,1934,2313
4219408,WITMARSUM,SC,0.228,0.772,568,1924,2492
4215406,SALTO VELOSO,SC,0.29,0.71,765,1874,2639
4218251,TIMBÓ GRANDE,SC,0.515,0.485,1958,1846,3804
4211405,NOVA ERECHIM,SC,0.395,0.605,1201,1841,3042
4201604,ARROIO TRINTA,SC,0.229,0.771,546,1837,2383
4215901,SÃO BONIFÁCIO,SC,0.153,0.847,332,1833,2165
4206801,IBICARÉ,SC,0.227,0.773,534,1823,2357
4212007,PALMA SOLA,SC,0.556,0.444,2273,1813,4086
4213302,PONTE ALTA,SC,0.393,0.607,1153,1779,2932
4214300,RANCHO QUEIMADO,SC,0.211,0.789,475,1775,2250
4207601,IPIRA,SC,0.382,0.618,1094,1767,2861
4209854,LINDÓIA DO SUL,SC,0.369,0.631,1026,1753,2779
4207577,IOMERÊ,SC,0.205,0.795,450,1742,2192
4210209,MAJOR GERCINO,SC,0.245,0.755,563,1733,2296
4205100,DONA EMMA,SC,0.271,0.729,639,1718,2357
4215075,RIQUEZA,SC,0.433,0.567,1309,1715,3024
4209805,LEOBERTO LEAL,SC,0.281,0.719,661,1690,2351
4219606,XAVANTINA,SC,0.422,0.578,1215,1666,2881
4204103,CAXAMBU DO SUL,SC,0.524,0.476,1810,1645,3455
4212601,PERITIBA,SC,0.259,0.741,568,1623,2191
4201109,ANITÁPOLIS,SC,0.277,0.723,620,1617,2237
4210902,MODELO,SC,0.384,0.616,1007,1617,2624
4215208,ROMELÂNDIA,SC,0.462,0.538,1386,1611,2997
4200507,ÁGUAS DE CHAPECÓ,SC,0.569,0.431,2061,1559,3620
4202503,BOM JARDIM DA SERRA,SC,0.406,0.594,1060,1549,2609
4211454,NOVA ITABERABA,SC,0.513,0.487,1619,1539,3158
4216057,SÃO CRISTÓVÃO DO SUL,SC,0.366,0.634,881,1526,2407
4212239,PARAÍSO,SC,0.454,0.546,1245,1500,2745
4202438,BOCAINA DO SUL,SC,0.373,0.627,881,1484,2365
4212056,PALMEIRA,SC,0.291,0.709,590,1437,2027
4213005,PINHEIRO PRETO,SC,0.319,0.681,668,1429,2097
4203253,CAPÃO ALTO,SC,0.323,0.677,680,1427,2107
4210852,MIRIM DOCE,SC,0.247,0.753,456,1387,1843
4204194,CHAPADÃO DO LAGEADO,SC,0.308,0.692,612,1375,1987
4219853,ZORTÉA,SC,0.347,0.653,727,1368,2095
4217550,SERRA ALTA,SC,0.373,0.627,806,1353,2159
4205191,ERMO,SC,0.194,0.806,322,1338,1660
4207684,IPUAÇU,SC,0.674,0.326,2621,1265,3886
4214102,PRESIDENTE NEREU,SC,0.213,0.787,339,1252,1591
4209201,LACERDÓPOLIS,SC,0.206,0.794,322,1240,1562
4214151,PRINCESA,SC,0.379,0.621,744,1221,1965
4219101,VARGEÃO,SC,0.468,0.532,1046,1190,2236
4212270,PASSOS MAIA,SC,0.538,0.462,1382,1185,2567
4218855,UNIÃO DO OESTE,SC,0.401,0.599,792,1183,1975
4202875,BRUNÓPOLIS,SC,0.446,0.554,938,1165,2103
4205605,GALVÃO,SC,0.46,0.54,990,1161,2151
4215604,SANTA ROSA DE LIMA,SC,0.253,0.747,391,1156,1547
4200051,ABDON BATISTA,SC,0.374,0.626,687,1151,1838
4213351,PONTE ALTA DO NORTE,SC,0.407,0.593,767,1117,1884
4202081,BANDEIRANTE,SC,0.472,0.528,1000,1117,2117
4200754,ALTO BELA VISTA,SC,0.295,0.705,445,1063,1508
4218954,URUPEMA,SC,0.37,0.63,624,1062,1686
4215059,RIO RUFINO,SC,0.363,0.637,605,1060,1665
4202156,BELMONTE,SC,0.43,0.57,792,1049,1841
4213906,PRESIDENTE CASTELLO BRANCO,SC,0.199,0.801,260,1049,1309
4201653,ARVOREDO,SC,0.43,0.57,786,1044,1830
4205555,FREI ROGÉRIO,SC,0.382,0.618,644,1041,1685
4204152,CELSO RAMOS,SC,0.451,0.549,855,1041,1896
4211892,PAINEL,SC,0.419,0.581,746,1033,1779
4200556,ÁGUAS FRIAS,SC,0.464,0.536,891,1031,1922
4211652,NOVO HORIZONTE,SC,0.448,0.552,807,995,1802
4217758,SUL BRASIL,SC,0.491,0.509,949,985,1934
4213153,PLANALTO ALEGRE,SC,0.549,0.451,1198,985,2183
4210555,MAREMA,SC,0.398,0.602,650,982,1632
4202537,BOM JESUS,SC,0.485,0.515,899,953,1852
4202578,BOM JESUS DO OESTE,SC,0.369,0.631,551,941,1492
4215554,SANTA HELENA,SC,0.448,0.552,759,935,1694
4211850,OURO VERDE,SC,0.378,0.622,562,925,1487
4206751,IBIAM,SC,0.342,0.658,476,916,1392
4219150,VARGEM,SC,0.51,0.49,944,906,1850
4215356,SALTINHO,SC,0.627,0.373,1497,890,2387
4209177,JUPIÁ,SC,0.458,0.542,739,874,1613
4204756,CUNHATAÍ,SC,0.377,0.623,530,874,1404
4205431,FORMOSA DO SUL,SC,0.535,0.465,991,862,1853
4204178,CERRO NEGRO,SC,0.638,0.362,1465,832,2297
4204459,CORONEL MARTINS,SC,0.504,0.496,802,790,1592
4215752,SÃO BERNARDINO,SC,0.57,0.43,1043,788,1831
4217956,TIGRINHOS,SC,0.469,0.531,690,782,1472
4202099,BARRA BONITA,SC,0.442,0.558,615,776,1391
4210050,MACIEIRA,SC,0.416,0.584,546,767,1313
4209458,LAJEADO GRANDE,SC,0.332,0.668,377,757,1134
4210704,MATOS COSTA,SC,0.54,0.46,880,751,1631
4207858,IRATI,SC,0.503,0.497,757,749,1506
4203154,CALMON,SC,0.636,0.364,1307,747,2054
4208955,JARDINÓPOLIS,SC,0.42,0.58,526,727,1253
4215687,SANTA TEREZINHA DO PROGRESSO,SC,0.598,0.402,1066,717,1783
4211876,PAIAL,SC,0.501,0.499,694,692,1386
4217154,SÃO MIGUEL DA BOA VISTA,SC,0.521,0.479,663,610,1273
4205357,FLOR DO SERTÃO,SC,0.519,0.481,652,604,1256
4205175,ENTRE RIOS,SC,0.736,0.264,1564,562,2126
4215695,SANTIAGO DO SUL,SC,0.525,0.475,620,560,1180
3550308,SÃO PAULO,SP,0.396,0.604,2424125,3694834,6118959
3509502,CAMPINAS,SP,0.312,0.688,181841,401284,583125
3518800,GUARULHOS,SP,0.339,0.661,203594,397523,601117
3549904,SÃO JOSÉ DOS CAMPOS,SP,0.238,0.762,87356,279797,367153
3547809,SANTO ANDRÉ,SP,0.332,0.668,131021,264039,395060
3548708,SÃO BERNARDO DO CAMPO,SP,0.404,0.596,175284,258269,433553
3552205,SOROCABA,SP,0.263,0.737,91927,257866,349793
3534401,OSASCO,SP,0.369,0.631,143603,245969,389572
3543402,RIBEIRÃO PRETO,SP,0.277,0.723,82528,215117,297645
3549805,SÃO JOSÉ DO RIO PRETO,SP,0.217,0.783,49211,177175,226386
3525904,JUNDIAÍ,SP,0.22,0.78,48827,173143,221970
3548500,SANTOS,SP,0.286,0.714,67785,168843,236628
3538709,PIRACICABA,SP,0.215,0.785,43260,158008,201268
3530607,MOGI DAS CRUZES,SP,0.287,0.713,60367,149953,210320
3506003,BAURU,SP,0.271,0.729,49704,133954,183658
3529401,MAUÁ,SP,0.379,0.621,78638,128689,207327
3554102,TAUBATÉ,SP,0.19,0.81,30037,128269,158306
3526902,LIMEIRA,SP,0.176,0.824,27257,127375,154632
3516200,FRANCA,SP,0.246,0.754,41285,126487,167772
3513801,DIADEMA,SP,0.48,0.52,108740,117805,226545
3510609,CARAPICUÍBA,SP,0.411,0.589,80671,115383,196054
3551009,SÃO VICENTE,SP,0.335,0.665,57415,113848,171263
3505708,BARUERI,SP,0.371,0.629,64279,109197,173476
3518701,GUARUJÁ,SP,0.328,0.672,50938,104510,155448
3541000,PRAIA GRANDE,SP,0.277,0.723,39211,102534,141745
3501608,AMERICANA,SP,0.215,0.785,27044,98605,125649
3552502,SUZANO,SP,0.325,0.675,47201,98160,145361
3529005,MARÍLIA,SP,0.2,0.8,23536,94124,117660
3541406,PRESIDENTE PRUDENTE,SP,0.22,0.78,25387,90190,115577
3523107,ITAQUAQUECETUBA,SP,0.416,0.584,64242,90182,154424
3524402,JACAREÍ,SP,0.223,0.777,25569,88982,114551
3552403,SUMARÉ,SP,0.315,0.685,40727,88674,129401
3520509,INDAIATUBA,SP,0.233,0.767,26816,88374,115190
3548906,SÃO CARLOS,SP,0.327,0.673,40433,83202,123635
3543907,RIO CLARO,SP,0.209,0.791,21484,81089,102573
3502804,ARAÇATUBA,SP,0.203,0.797,20424,80353,100777
3552809,TABOÃO DA SERRA,SP,0.452,0.548,64301,77834,142135
3548807,SÃO CAETANO DO SUL,SP,0.249,0.751,25514,77010,102524
3545803,SANTA BÁRBARA D'OESTE,SP,0.227,0.773,22479,76429,98908
3513009,COTIA,SP,0.374,0.626,43296,72473,115769
3503208,ARARAQUARA,SP,0.364,0.636,40311,70340,110651
3519071,HORTOLÂNDIA,SP,0.343,0.657,35843,68606,104449
3515004,EMBU DAS ARTES,SP,0.457,0.543,57509,68422,125931
3507605,BRAGANÇA PAULISTA,SP,0.201,0.799,16995,67605,84600
3523909,ITU,SP,0.228,0.772,18904,64175,83079
3530706,MOGI GUAÇU,SP,0.183,0.817,14361,64012,78373
3538006,PINDAMONHANGABA,SP,0.21,0.79,16054,60525,76579
3522307,ITAPETININGA,SP,0.212,0.788,15586,57906,73492
3525300,JAÚ,SP,0.175,0.825,12272,57771,70043
3522505,ITAPEVI,SP,0.43,0.57,43108,57076,100184
3504107,ATIBAIA,SP,0.215,0.785,15439,56292,71731
3503307,ARARAS,SP,0.198,0.802,13466,54587,68053
3507506,BOTUCATU,SP,0.264,0.736,18725,52219,70944
3518404,GUARATINGUETÁ,SP,0.212,0.788,13689,50772,64461
3506508,BIRIGUI,SP,0.169,0.831,10302,50564,60866
3511102,CATANDUVA,SP,0.212,0.788,13376,49732,63108
3556206,VALINHOS,SP,0.227,0.773,14322,48664,62986
3515707,FERRAZ DE VASCONCELOS,SP,0.429,0.571,36186,48212,84398
3545209,SALTO,SP,0.249,0.751,15501,46789,62290
3557006,VOTORANTIM,SP,0.261,0.739,16250,46025,62275
3554003,TATUÍ,SP,0.196,0.804,11048,45426,56474
3523404,ITATIBA,SP,0.202,0.798,11253,44476,55729
3510500,CARAGUATATUBA,SP,0.288,0.712,17363,42855,60218
3551702,SERTÃOZINHO,SP,0.291,0.709,17181,41928,59109
3522208,ITAPECERICA DA SERRA,SP,0.457,0.543,35079,41677,76756
3543303,RIBEIRÃO PIRES,SP,0.333,0.667,20501,41053,61554
3539806,POÁ,SP,0.354,0.646,22471,40969,63440
3505500,BARRETOS,SP,0.26,0.74,14354,40754,55108
3547304,SANTANA DE PARNAÍBA,SP,0.33,0.67,20077,40706,60783
3556503,VÁRZEA PAULISTA,SP,0.28,0.72,15480,39776,55256
3508504,CAÇAPAVA,SP,0.188,0.812,9171,39663,48834
3534708,OURINHOS,SP,0.253,0.747,13350,39357,52707
3516309,FRANCISCO MORATO,SP,0.509,0.491,40445,39062,79507
3513504,CUBATÃO,SP,0.396,0.604,25584,39026,64610
3516408,FRANCO DA ROCHA,SP,0.419,0.581,27499,38078,65577
3526704,LEME,SP,0.229,0.771,11306,38007,49313
3530805,MOGI MIRIM,SP,0.181,0.819,8423,37986,46409
3536505,PAULÍNIA,SP,0.286,0.714,14863,37123,51986
3549102,SÃO JOÃO DA BOA VISTA,SP,0.215,0.785,10015,36546,46561
3557105,VOTUPORANGA,SP,0.225,0.775,10502,36114,46616
3504008,ASSIS,SP,0.266,0.734,12785,35336,48121
3522406,ITAPEVA,SP,0.259,0.741,11919,34188,46107
3556701,VINHEDO,SP,0.203,0.797,8704,34113,42817
3527207,LORENA,SP,0.209,0.791,8929,33879,42808
3525003,JANDIRA,SP,0.382,0.618,20346,32976,53322
3504503,AVARÉ,SP,0.226,0.774,9550,32653,42203
3555406,UBATUBA,SP,0.266,0.734,11741,32462,44203
3539301,PIRASSUNUNGA,SP,0.182,0.818,7167,32142,39309
3522109,ITANHAÉM,SP,0.311,0.689,14314,31784,46098
3503901,ARUJÁ,SP,0.305,0.695,13943,31746,45689
3527108,LINS,SP,0.166,0.834,6317,31675,37992
3506102,BEBEDOURO,SP,0.205,0.795,7831,30396,38227
3529302,MATÃO,SP,0.296,0.704,12776,30373,43149
3522604,ITAPIRA,SP,0.198,0.802,7478,30289,37767
3528502,MAIRIPORÃ,SP,0.262,0.738,10743,30283,41026
3513405,CRUZEIRO,SP,0.235,0.765,9254,30111,39365
3509007,CAIEIRAS,SP,0.35,0.65,16144,29988,46132
3501905,AMPARO,SP,0.194,0.806,7048,29332,36380
3526803,LENÇÓIS PAULISTA,SP,0.168,0.832,5874,29023,34897
3519709,IBIÚNA,SP,0.23,0.77,8646,28966,37612
3509601,CAMPO LIMPO PAULISTA,SP,0.288,0.712,11705,28924,40629
3550605,SÃO ROQUE,SP,0.268,0.732,10351,28284,38635
3509205,CAJAMAR,SP,0.361,0.639,15248,26934,42182
3524303,JABOTICABAL,SP,0.23,0.77,7937,26606,34543
3555000,TUPÃ,SP,0.2,0.8,6625,26574,33199
3550704,SÃO SEBASTIÃO,SP,0.376,0.624,14986,24898,39884
3515509,FERNANDÓPOLIS,SP,0.276,0.724,9414,24660,34074
3530508,MOCOCA,SP,0.247,0.753,7963,24341,32304
3533403,NOVA ODESSA,SP,0.259,0.741,8377,23989,32366
3537602,PERUÍBE,SP,0.307,0.693,10296,23235,33531
3537305,PENÁPOLIS,SP,0.248,0.752,7460,22610,30070
3530300,MIRASSOL,SP,0.222,0.778,6403,22447,28850
3540705,PORTO FERREIRA,SP,0.198,0.802,5502,22295,27797
3540606,PORTO FELIZ,SP,0.203,0.797,5652,22178,27830
3519600,IBITINGA,SP,0.238,0.762,6888,22062,28950
3507001,BOITUVA,SP,0.231,0.769,6524,21746,28270
3524006,ITUPEVA,SP,0.232,0.768,6544,21693,28237
3524709,JAGUARIÚNA,SP,0.222,0.778,6098,21336,27434
3515103,EMBU-GUAÇU,SP,0.37,0.63,12537,21334,33871
3512803,COSMÓPOLIS,SP,0.299,0.701,9109,21333,30442
3542602,REGISTRO,SP,0.283,0.717,8333,21153,29486
3502101,ANDRADINA,SP,0.284,0.716,8274,20882,29156
3510401,CAPIVARI,SP,0.201,0.799,5228,20783,26011
3533908,OLÍMPIA,SP,0.237,0.763,6422,20672,27094
3549706,SÃO JOSÉ DO RIO PARDO,SP,0.242,0.758,6545,20490,27035
3505906,BATATAIS,SP,0.291,0.709,8366,20371,28737
3546801,SANTA ISABEL,SP,0.257,0.743,7046,20358,27404
3511508,CERQUILHO,SP,0.165,0.835,4010,20269,24279
3537800,PIEDADE,SP,0.271,0.729,7451,20074,27525
3531308,MONTE ALTO,SP,0.187,0.813,4604,19985,24589
3524808,JALES,SP,0.225,0.775,5694,19587,25281
3546405,SANTA CRUZ DO RIO PARDO,SP,0.183,0.817,4309,19301,23610
3537107,PEDREIRA,SP,0.174,0.826,4055,19185,23240
3514403,DRACENA,SP,0.197,0.803,4710,19141,23851
3527306,LOUVEIRA,SP,0.243,0.757,5961,18600,24561
3506359,BERTIOGA,SP,0.324,0.676,8884,18527,27411
3509700,CAMPOS DO JORDÃO,SP,0.229,0.771,5455,18414,23869
3531100,MONGAGUÁ,SP,0.322,0.678,8719,18364,27083
3503802,ARTUR NOGUEIRA,SP,0.257,0.743,6342,18341,24683
3553708,TAQUARITINGA,SP,0.283,0.717,7212,18278,25490
3516705,GARÇA,SP,0.203,0.797,4647,18233,22880
3531803,MONTE MOR,SP,0.343,0.657,9225,17676,26901
3536703,PEDERNEIRAS,SP,0.217,0.783,4896,17622,22518
3528403,MAIRINQUE,SP,0.286,0.714,7040,17565,24605
3510203,CAPÃO BONITO,SP,0.257,0.743,6044,17480,23524
3556453,VARGEM GRANDE PAULISTA,SP,0.337,0.663,8774,17252,26026
3523206,ITARARÉ,SP,0.256,0.744,5886,17141,23027
3508405,CABREÚVA,SP,0.249,0.751,5680,17136,22816
3552106,SOCORRO,SP,0.151,0.849,3039,17090,20129
3554508,TIETÊ,SP,0.185,0.815,3825,16856,20681
3515186,ESPÍRITO SANTO DO PINHAL,SP,0.23,0.77,4926,16536,21462
3549409,SÃO JOAQUIM DA BARRA,SP,0.309,0.691,7321,16374,23695
3556404,VARGEM GRANDE DO SUL,SP,0.201,0.799,4103,16342,20445
3502507,APARECIDA,SP,0.22,0.78,4553,16138,20691
3505302,BARRA BONITA,SP,0.226,0.774,4666,15951,20617
3522703,ITÁPOLIS,SP,0.203,0.797,4029,15842,19871
3533502,NOVO HORIZONTE,SP,0.223,0.777,4435,15451,19886
3500709,AGUDOS,SP,0.229,0.771,4571,15379,19950
3550100,SÃO MANUEL,SP,0.24,0.76,4839,15328,20167
3541505,PRESIDENTE VENCESLAU,SP,0.219,0.781,4254,15173,19427
3534302,ORLÂNDIA,SP,0.255,0.745,5161,15111,20272
3500105,ADAMANTINA,SP,0.173,0.827,3156,15088,18244
3554805,TREMEMBÉ,SP,0.209,0.791,3932,14843,18775
3551504,SERRANA,SP,0.331,0.669,7259,14648,21907
3535507,PARAGUAÇU PAULISTA,SP,0.301,0.699,6277,14579,20856
3550407,SÃO PEDRO,SP,0.178,0.822,3133,14483,17616
3545308,SALTO DE PIRAPORA,SP,0.286,0.714,5774,14417,20191
3525102,JARDINÓPOLIS,SP,0.218,0.782,3943,14129,18072
3525706,JOSÉ BONIFÁCIO,SP,0.244,0.756,4393,13648,18041
3544103,RIO GRANDE DA SERRA,SP,0.408,0.592,9376,13583,22959
3517406,GUAÍRA,SP,0.265,0.735,4898,13565,18463
3513108,CRAVINHOS,SP,0.207,0.793,3539,13546,17085
3505203,BARIRI,SP,0.174,0.826,2855,13538,16393
3541307,PRESIDENTE EPITÁCIO,SP,0.306,0.694,5915,13437,19352
3513702,DESCALVADO,SP,0.189,0.811,3129,13415,16544
3524105,ITUVERAVA,SP,0.288,0.712,5344,13229,18573
3502903,ARAÇOIABA DA SERRA,SP,0.228,0.772,3881,13130,17011
3546603,SANTA FÉ DO SUL,SP,0.214,0.786,3560,13054,16614
3534609,OSVALDO CRUZ,SP,0.184,0.816,2944,13016,15960
3510005,CÂNDIDO MOTA,SP,0.222,0.778,3708,12990,16698
3544004,RIO DAS PEDRAS,SP,0.243,0.757,4132,12839,16971
3518602,GUARIBA,SP,0.324,0.676,6142,12825,18967
3518305,GUARAREMA,SP,0.233,0.767,3891,12788,16679
3541604,PROMISSÃO,SP,0.298,0.702,5333,12565,17898
3518206,GUARARAPES,SP,0.216,0.784,3443,12499,15942
3508603,CACHOEIRA PAULISTA,SP,0.277,0.723,4652,12126,16778
3551603,SERRA NEGRA,SP,0.183,0.817,2712,12094,14806
3540200,PONTAL,SP,0.324,0.676,5791,12077,17868
3512209,CONCHAL,SP,0.18,0.82,2627,12002,14629
3526407,LARANJAL PAULISTA,SP,0.172,0.828,2482,11916,14398
3550209,SÃO MIGUEL ARCANJO,SP,0.277,0.723,4560,11888,16448
3547502,SANTA RITA DO PASSA QUATRO,SP,0.176,0.824,2484,11659,14143
3538600,PIRACAIA,SP,0.198,0.802,2878,11625,14503
3519303,IBATÉ,SP,0.312,0.688,5182,11452,16634
3537909,PILAR DO SUL,SP,0.231,0.769,3437,11439,14876
3539509,PITANGUEIRAS,SP,0.319,0.681,5335,11391,16726
3506607,BIRITIBA MIRIM,SP,0.252,0.748,3818,11348,15166
3525201,JARINU,SP,0.244,0.756,3659,11346,15005
3509254,CAJATI,SP,0.248,0.752,3712,11259,14971
3542206,RANCHARIA,SP,0.307,0.693,4961,11199,16160
3546306,SANTA CRUZ DAS PALMEIRAS,SP,0.265,0.735,4002,11123,15125
3538808,PIRAJU,SP,0.259,0.741,3880,11080,14960
3520400,ILHABELA,SP,0.318,0.682,5042,10815,15857
3500303,AGUAÍ,SP,0.287,0.713,4335,10765,15100
3553401,TANABI,SP,0.228,0.772,3143,10629,13772
3501707,AMÉRICO BRASILIENSE,SP,0.417,0.583,7524,10503,18027
3512407,CORDEIRÓPOLIS,SP,0.222,0.778,2904,10191,13095
3510807,CASA BRANCA,SP,0.208,0.792,2670,10147,12817
3521408,IRACEMÁPOLIS,SP,0.212,0.788,2732,10139,12871
3530102,MIRANDÓPOLIS,SP,0.212,0.788,2699,10035,12734
3505807,BASTOS,SP,0.165,0.835,1970,9951,11921
3514106,DOIS CÓRREGOS,SP,0.212,0.788,2654,9845,12499
3546702,SANTA GERTRUDES,SP,0.222,0.778,2778,9755,12533
3505609,BARRINHA,SP,0.389,0.611,6025,9469,15494
3507902,BROTAS,SP,0.202,0.798,2373,9364,11737
3540002,POMPÉIA,SP,0.186,0.814,2135,9331,11466
3539202,PIRAPOZINHO,SP,0.307,0.693,4133,9312,13445
3520301,IGUAPE,SP,0.325,0.675,4452,9249,13701
3531902,MORRO AGUDO,SP,0.308,0.692,4089,9198,13287
3507803,BRODOWSKI,SP,0.199,0.801,2279,9157,11436
3526209,JUQUITIBA,SP,0.376,0.624,5427,8993,14420
3548005,SANTO ANTÔNIO DE POSSE,SP,0.213,0.787,2397,8882,11279
3520442,ILHA SOLTEIRA,SP,0.323,0.677,4182,8755,12937
3520004,IGARAÇU DO TIETÊ,SP,0.281,0.719,3418,8735,12153
3529203,MARTINÓPOLIS,SP,0.292,0.708,3596,8734,12330
3537404,PEREIRA BARRETO,SP,0.311,0.689,3915,8684,12599
3507100,BOM JESUS DOS PERDÕES,SP,0.244,0.756,2769,8597,11366
3547601,SANTA ROSA DE VITERBO,SP,0.294,0.706,3554,8540,12094
3501301,ÁLVARES MACHADO,SP,0.299,0.701,3640,8536,12176
3531407,MONTE APRAZÍVEL,SP,0.258,0.742,2964,8523,11487
3535309,PALMITAL,SP,0.262,0.738,3018,8520,11538
3521002,IPERÓ,SP,0.356,0.644,4683,8473,13156
3500501,ÁGUAS DE LINDÓIA,SP,0.172,0.828,1712,8221,9933
3520103,IGARAPAVA,SP,0.384,0.616,5004,8041,13045
3502200,ANGATUBA,SP,0.339,0.661,4055,7903,11958
3538907,PIRAJUÍ,SP,0.227,0.773,2306,7875,10181
3553807,TAQUARITUBA,SP,0.344,0.656,4108,7829,11937
3513603,CUNHA,SP,0.323,0.677,3725,7824,11549
3510302,CAPELA DO ALTO,SP,0.204,0.796,1976,7699,9675
3553302,TAMBAÚ,SP,0.293,0.707,3148,7596,10744
3542404,REGENTE FEIJÓ,SP,0.271,0.729,2814,7553,10367
3556305,VALPARAÍSO,SP,0.292,0.708,3071,7449,10520
3545001,SALESÓPOLIS,SP,0.257,0.743,2566,7429,9995
3509403,CAJURU,SP,0.368,0.632,4320,7421,11741
3531506,MONTE AZUL PAULISTA,SP,0.234,0.766,2263,7408,9671
3508009,BURI,SP,0.281,0.719,2884,7390,10274
3526001,JUNQUEIRÓPOLIS,SP,0.237,0.763,2297,7384,9681
3502705,APIAÍ,SP,0.413,0.587,5069,7214,12283
3502754,ARAÇARIGUAMA,SP,0.307,0.693,3192,7212,10404
3556800,VIRADOURO,SP,0.228,0.772,2120,7182,9302
3511409,CERQUEIRA CÉSAR,SP,0.265,0.735,2572,7135,9707
3547700,SANTO ANASTÁCIO,SP,0.316,0.684,3286,7122,10408
3536208,PARIQUERA-AÇU,SP,0.253,0.747,2407,7104,9511
3521903,ITAJOBI,SP,0.162,0.838,1372,7102,8474
3528007,MACATUBA,SP,0.217,0.783,1959,7084,9043
3511706,CHARQUEADA,SP,0.209,0.791,1865,7063,8928
3515152,ENGENHEIRO COELHO,SP,0.285,0.715,2810,7049,9859
3517505,GUAPIAÇU,SP,0.283,0.717,2774,7041,9815
3504602,BADY BASSITT,SP,0.202,0.798,1762,6953,8715
3511607,CESÁRIO LANGE,SP,0.174,0.826,1466,6939,8405
3527405,LUCÉLIA,SP,0.232,0.768,2091,6931,9022
3512308,CONCHAS,SP,0.21,0.79,1836,6887,8723
3514908,ELIAS FAUSTO,SP,0.222,0.778,1950,6815,8765
3526100,JUQUIÁ,SP,0.278,0.722,2622,6815,9437
3523503,ITATINGA,SP,0.267,0.733,2481,6814,9295
3532405,NAZARÉ PAULISTA,SP,0.236,0.764,2088,6753,8841
3529906,MIRACATU,SP,0.332,0.668,3274,6585,9859
3521804,ITAÍ,SP,0.411,0.589,4583,6556,11139
3540804,POTIRENDABA,SP,0.243,0.757,2098,6553,8651
3501152,ALUMÍNIO,SP,0.319,0.681,3054,6530,9584
3508801,CAFELÂNDIA,SP,0.239,0.761,2029,6467,8496
3540754,POTIM,SP,0.253,0.747,2169,6404,8573
3533007,NOVA GRANADA,SP,0.347,0.653,3403,6394,9797
3524600,JACUPIRANGA,SP,0.244,0.756,2051,6358,8409
3540903,PRADÓPOLIS,SP,0.302,0.698,2710,6276,8986
3508108,BURITAMA,SP,0.277,0.723,2393,6252,8645
3546009,SANTA BRANCA,SP,0.236,0.764,1929,6230,8159
3535606,PARAIBUNA,SP,0.34,0.66,3183,6189,9372
3512001,COLINA,SP,0.33,0.67,3022,6144,9166
3532009,MORUNGABA,SP,0.182,0.818,1355,6096,7451
3521705,ITABERÁ,SP,0.385,0.615,3802,6066,9868
3551900,SEVERÍNIA,SP,0.28,0.72,2354,6065,8419
3508702,CACONDE,SP,0.347,0.653,3160,5956,9116
3554300,TEODORO SAMPAIO,SP,0.469,0.531,5234,5936,11170
3538105,PINDORAMA,SP,0.239,0.761,1858,5915,7773
3507407,BORBOREMA,SP,0.194,0.806,1420,5904,7324
3535804,PARANAPANEMA,SP,0.364,0.636,3381,5898,9279
3519055,HOLAMBRA,SP,0.224,0.776,1695,5866,7561
3555109,TUPI PAULISTA,SP,0.261,0.739,2039,5779,7818
3517703,GUARÁ,SP,0.399,0.601,3833,5779,9612
3515400,FARTURA,SP,0.322,0.678,2741,5772,8513
3550902,SÃO SIMÃO,SP,0.262,0.738,2034,5734,7768
3556008,URUPÊS,SP,0.217,0.783,1572,5667,7239
3553955,TARUMÃ,SP,0.284,0.716,2247,5665,7912
3545605,SANTA ADÉLIA,SP,0.232,0.768,1703,5649,7352
3520905,IPAUSSU,SP,0.241,0.759,1773,5575,7348
3504206,AURIFLAMA,SP,0.289,0.711,2255,5561,7816
3528809,MARACAÍ,SP,0.276,0.724,2118,5548,7666
3529708,MIGUELÓPOLIS,SP,0.423,0.577,4069,5545,9614
3538501,PIQUETE,SP,0.205,0.795,1412,5482,6894
3538204,PINHALZINHO,SP,0.2,0.8,1364,5461,6825
3536307,PATROCÍNIO PAULISTA,SP,0.268,0.732,1940,5293,7233
3543006,RIBEIRÃO BRANCO,SP,0.461,0.539,4489,5242,9731
3541703,QUATÁ,SP,0.264,0.736,1869,5221,7090
3522802,ITAPORANGA,SP,0.307,0.693,2300,5204,7504
3525508,JOANÓPOLIS,SP,0.194,0.806,1231,5122,6353
3501004,ALTINÓPOLIS,SP,0.362,0.638,2905,5115,8020
3513900,DIVINOLÂNDIA,SP,0.23,0.77,1519,5084,6603
3541208,PRESIDENTE BERNARDES,SP,0.31,0.69,2281,5072,7353
3529807,MINEIROS DO TIETÊ,SP,0.186,0.814,1148,5035,6183
3511003,CASTILHO,SP,0.491,0.509,4821,5005,9826
3539400,PIRATININGA,SP,0.225,0.775,1452,5001,6453
3552700,TABATINGA,SP,0.329,0.671,2428,4951,7379
3539103,PIRAPORA DO BOM JESUS,SP,0.401,0.599,3302,4938,8240
3517604,GUAPIARA,SP,0.48,0.52,4528,4914,9442
3506805,BOCAINA,SP,0.188,0.812,1134,4892,6026
3514502,DUARTINA,SP,0.283,0.717,1922,4879,6801
3519402,IBIRÁ,SP,0.206,0.794,1258,4842,6100
3552601,TABAPUÃ,SP,0.221,0.779,1371,4821,6192
3549953,SÃO LOURENÇO DA SERRA,SP,0.37,0.63,2828,4808,7636
3556107,VALENTIM GENTIL,SP,0.253,0.747,1616,4771,6387
3523602,ITIRAPINA,SP,0.282,0.718,1865,4739,6604
3522901,ITAPUÍ,SP,0.24,0.76,1491,4711,6202
3535408,PANORAMA,SP,0.319,0.681,2186,4670,6856
3548609,SÃO BENTO DO SAPUCAÍ,SP,0.227,0.773,1370,4667,6037
3557303,ESTIVA GERBI,SP,0.23,0.77,1395,4662,6057
3518503,GUAREÍ,SP,0.22,0.78,1294,4601,5895
3544251,ROSANA,SP,0.49,0.51,4417,4592,9009
3520426,ILHA COMPRIDA,SP,0.303,0.697,1998,4586,6584
3557204,CHAVANTES,SP,0.276,0.724,1738,4551,6289
3550001,SÃO LUÍS DO PARAITINGA,SP,0.312,0.688,2033,4486,6519
3544301,ROSEIRA,SP,0.24,0.76,1409,4461,5870
3545159,SALTINHO,SP,0.108,0.892,539,4454,4993
3521309,IPUÃ,SP,0.408,0.592,3043,4408,7451
3542107,RAFARD,SP,0.189,0.811,1022,4378,5400
3553609,TAPIRATIBA,SP,0.361,0.639,2454,4350,6804
3532603,NHANDEARA,SP,0.21,0.79,1153,4335,5488
3539004,PIRANGI,SP,0.207,0.793,1129,4320,5449
3553005,TAGUAÍ,SP,0.303,0.697,1878,4314,6192
3519105,IACANGA,SP,0.215,0.785,1183,4307,5490
3534906,PACAEMBU,SP,0.241,0.759,1359,4286,5645
3537008,PEDREGULHO,SP,0.458,0.542,3605,4262,7867
3520202,IGARATÁ,SP,0.241,0.759,1344,4225,5569
3504800,BÁLSAMO,SP,0.185,0.815,955,4204,5159
3544905,SALES OLIVEIRA,SP,0.262,0.738,1487,4182,5669
3516903,GENERAL SALGADO,SP,0.275,0.725,1581,4170,5751
3506300,BERNARDINO DE CAMPOS,SP,0.251,0.749,1386,4140,5526
3551801,SETE BARRAS,SP,0.334,0.666,2072,4123,6195
3535002,PALESTINA,SP,0.321,0.679,1940,4109,6049
3509908,CANANÉIA,SP,0.321,0.679,1944,4107,6051
3517208,GUAIÇARA,SP,0.264,0.736,1471,4101,5572
3556602,VERA CRUZ,SP,0.259,0.741,1426,4082,5508
3536000,PARAPUÃ,SP,0.264,0.736,1462,4079,5541
3543808,RINÓPOLIS,SP,0.209,0.791,1079,4076,5155
3554706,TORRINHA,SP,0.203,0.797,1024,4030,5054
3523305,ITARIRI,SP,0.299,0.701,1705,3992,5697
3530201,MIRANTE DO PARANAPANEMA,SP,0.537,0.463,4574,3947,8521
3527603,LUÍS ANTÔNIO,SP,0.348,0.652,2101,3940,6041
3555604,UCHOA,SP,0.272,0.728,1469,3927,5396
3550803,SÃO SEBASTIÃO DA GRAMA,SP,0.302,0.698,1695,3915,5610
3514809,ELDORADO,SP,0.456,0.544,3256,3890,7146
3511300,CEDRAL,SP,0.203,0.797,991,3890,4881
3516002,FLÓRIDA PAULISTA,SP,0.295,0.705,1626,3880,5506
3510708,CARDOSO,SP,0.381,0.619,2379,3859,6238
3509304,CAJOBI,SP,0.285,0.715,1537,3847,5384
3503604,AREIÓPOLIS,SP,0.329,0.671,1861,3791,5652
3506409,BILAC,SP,0.185,0.815,852,3764,4616
3514601,DUMONT,SP,0.227,0.773,1088,3714,4802
3542909,RIBEIRÃO BONITO,SP,0.324,0.676,1778,3712,5490
3532504,NEVES PAULISTA,SP,0.269,0.731,1359,3699,5058
3528601,MANDURI,SP,0.247,0.753,1205,3680,4885
3503703,ARIRANHA,SP,0.248,0.752,1207,3668,4875
3515202,ESTRELA D'OESTE,SP,0.232,0.768,1095,3624,4719
3556354,VARGEM,SP,0.195,0.805,872,3589,4461
3513207,CRISTAIS PAULISTA,SP,0.278,0.722,1377,3576,4953
3506706,BOA ESPERANÇA DO SUL,SP,0.457,0.543,3013,3573,6586
3506904,BOFETE,SP,0.273,0.727,1338,3568,4906
3517000,GETULINA,SP,0.29,0.71,1414,3456,4870
3514304,DOURADO,SP,0.255,0.745,1164,3406,4570
3535200,PALMEIRA D'OESTE,SP,0.333,0.667,1698,3406,5104
3531209,MONTE ALEGRE DO SUL,SP,0.196,0.804,824,3389,4213
3535101,PALMARES PAULISTA,SP,0.348,0.652,1779,3332,5111
3527009,LINDÓIA,SP,0.18,0.82,726,3300,4026
3503406,AREALVA,SP,0.245,0.755,1063,3277,4340
3504404,AVANHANDAVA,SP,0.363,0.637,1855,3257,5112
3512902,COSMORAMA,SP,0.278,0.722,1250,3250,4500
3517802,GUARAÇAÍ,SP,0.271,0.729,1200,3233,4433
3555802,URÂNIA,SP,0.282,0.718,1262,3218,4480
3517901,GUARACI,SP,0.408,0.592,2195,3183,5378
3537503,PEREIRAS,SP,0.25,0.75,1057,3174,4231
3500402,ÁGUAS DA PRATA,SP,0.239,0.761,997,3172,4169
3548054,SANTO ANTÔNIO DO ARACANGUÁ,SP,0.335,0.665,1594,3165,4759
3540507,PORANGABA,SP,0.261,0.739,1109,3143,4252
3511201,CATIGUÁ,SP,0.228,0.772,928,3140,4068
3551108,SARAPUÍ,SP,0.324,0.676,1498,3125,4623
3534757,OUROESTE,SP,0.367,0.633,1812,3122,4934
3528106,MACAUBAL,SP,0.223,0.777,896,3119,4015
3519907,IEPÊ,SP,0.31,0.69,1389,3097,4486
3548203,SANTO ANTÔNIO DO PINHAL,SP,0.233,0.767,942,3093,4035
3504909,BANANAL,SP,0.441,0.559,2428,3078,5506
3554409,TERRA ROXA,SP,0.283,0.717,1206,3060,4266
3537206,PEDRO DE TOLEDO,SP,0.341,0.659,1584,3060,4644
3533601,NUPORANGA,SP,0.231,0.769,917,3045,3962
3519006,HERCULÂNDIA,SP,0.333,0.667,1484,2976,4460
3554953,TUIUTI,SP,0.191,0.809,703,2971,3674
3543709,RINCÃO,SP,0.426,0.574,2192,2957,5149
3521101,IPEÚNA,SP,0.201,0.799,744,2952,3696
3545407,SALTO GRANDE,SP,0.309,0.691,1315,2936,4251
3521507,IRAPUÃ,SP,0.235,0.765,889,2891,3780
3548104,SANTO ANTÔNIO DO JARDIM,SP,0.228,0.772,849,2879,3728
3532827,NOVA CAMPINA,SP,0.405,0.595,1960,2877,4837
3511904,CLEMENTINA,SP,0.257,0.743,987,2859,3846
3546900,SANTA LÚCIA,SP,0.411,0.589,1967,2824,4791
3532306,NATIVIDADE DA SERRA,SP,0.254,0.746,951,2786,3737
3523800,ITOBI,SP,0.339,0.661,1425,2783,4208
3532900,NOVA EUROPA,SP,0.452,0.548,2264,2740,5004
3524907,JAMBEIRO,SP,0.206,0.794,707,2732,3439
3551405,SERRA AZUL,SP,0.406,0.594,1861,2719,4580
3526605,LAVRINHAS,SP,0.338,0.662,1379,2698,4077
3524501,JACI,SP,0.264,0.736,965,2694,3659
3536109,PARDINHO,SP,0.273,0.727,1005,2681,3686
3503109,ARANDU,SP,0.31,0.69,1206,2679,3885
3544806,SALES,SP,0.19,0.81,630,2679,3309
3556909,VISTA ALEGRE DO ALTO,SP,0.293,0.707,1100,2656,3756
3541901,QUELUZ,SP,0.418,0.582,1904,2652,4556
3501806,AMÉRICO DE CAMPOS,SP,0.241,0.759,833,2630,3463
3519501,IBIRAREMA,SP,0.238,0.762,820,2629,3449
3542503,REGINÓPOLIS,SP,0.185,0.815,595,2621,3216
3536406,PAULICÉIA,SP,0.311,0.689,1182,2614,3796
3534104,ORIENTE,SP,0.262,0.738,923,2601,3524
3542701,RESTINGA,SP,0.404,0.596,1760,2599,4359
3532801,NOVA ALIANÇA,SP,0.253,0.747,881,2598,3479
3519204,IACRI,SP,0.247,0.753,845,2579,3424
3552304,SUD MENNUCCI,SP,0.403,0.597,1739,2579,4318
3519808,ICÉM,SP,0.369,0.631,1506,2576,4082
3550506,SÃO PEDRO DO TURVO,SP,0.335,0.665,1297,2574,3871
3549508,SÃO JOSÉ DA BELA VISTA,SP,0.403,0.597,1734,2571,4305
3553500,TAPIRAÍ,SP,0.326,0.674,1245,2570,3815
3543253,RIBEIRÃO GRANDE,SP,0.427,0.573,1898,2545,4443
3515608,FERNANDO PRESTES,SP,0.209,0.791,671,2538,3209
3535705,PARAÍSO,SP,0.234,0.766,765,2507,3272
3502309,ANHEMBI,SP,0.261,0.739,884,2504,3388
3544202,RIOLÂNDIA,SP,0.456,0.544,2102,2503,4605
3542008,QUINTANA,SP,0.298,0.702,1051,2473,3524
3518107,GUARANTÃ,SP,0.277,0.723,947,2472,3419
3537701,PIACATU,SP,0.274,0.726,930,2466,3396
3545704,SANTA ALBERTINA,SP,0.259,0.741,859,2454,3313
3500550,ÁGUAS DE SANTA BÁRBARA,SP,0.258,0.742,850,2448,3298
3526308,LAGOINHA,SP,0.28,0.72,949,2444,3393
3553203,TAIÚVA,SP,0.207,0.793,639,2441,3080
3536604,PAULO DE FARIA,SP,0.403,0.597,1645,2439,4084
3500758,ALAMBARI,SP,0.235,0.765,747,2432,3179
3514700,ECHAPORÃ,SP,0.307,0.693,1079,2431,3510
3536802,PEDRA BELA,SP,0.287,0.713,969,2405,3374
3507704,BRAÚNA,SP,0.22,0.78,677,2402,3079
3512506,COROADOS,SP,0.194,0.806,569,2369,2938
3521606,IRAPURU,SP,0.319,0.681,1109,2364,3473
3554904,TRÊS FRONTEIRAS,SP,0.298,0.702,981,2309,3290
3547908,SANTO ANTÔNIO DA ALEGRIA,SP,0.376,0.624,1382,2294,3676
3539905,POLONI,SP,0.253,0.747,772,2275,3047
3509452,CAMPINA DO MONTE ALEGRE,SP,0.303,0.697,982,2264,3246
3514007,DOBRADA,SP,0.453,0.547,1868,2260,4128
3552007,SILVEIRAS,SP,0.341,0.659,1167,2255,3422
3553856,TAQUARIVAÍ,SP,0.303,0.697,980,2255,3235
3534807,OURO VERDE,SP,0.459,0.541,1907,2244,4151
3546504,SANTA ERNESTINA,SP,0.36,0.64,1257,2232,3489
3546207,SANTA CRUZ DA CONCEIÇÃO,SP,0.195,0.805,532,2202,2734
3518859,GUATAPARÁ,SP,0.392,0.608,1417,2197,3614
3505104,BARBOSA,SP,0.345,0.655,1149,2178,3327
3521150,IPIGUÁ,SP,0.225,0.775,632,2174,2806
3512100,COLÔMBIA,SP,0.407,0.593,1480,2160,3640
3516606,GÁLIA,SP,0.38,0.62,1321,2157,3478
3520608,INDIANA,SP,0.249,0.751,715,2153,2868
3524204,JABORANDI,SP,0.375,0.625,1280,2132,3412
3529500,MENDONÇA,SP,0.31,0.69,953,2121,3074
3547007,SANTA MARIA DA SERRA,SP,0.258,0.742,721,2074,2795
3544608,SABINO,SP,0.293,0.707,857,2066,2923
3500600,ÁGUAS DE SÃO PEDRO,SP,0.214,0.786,560,2062,2622
3502002,ANALÂNDIA,SP,0.213,0.787,556,2050,2606
3508207,BURITIZAL,SP,0.21,0.79,545,2047,2592
3500204,ADOLFO,SP,0.245,0.755,661,2041,2702
3501202,ÁLVARES FLORENCE,SP,0.241,0.759,637,2008,2645
3542305,REDENÇÃO DA SERRA,SP,0.254,0.746,665,1958,2623
3552908,TACIBA,SP,0.442,0.558,1543,1949,3492
3501103,ALTO ALEGRE,SP,0.23,0.77,576,1932,2508
3553906,TARABAI,SP,0.469,0.531,1704,1928,3632
3509957,CANAS,SP,0.266,0.734,698,1927,2625
3541059,PRATÂNIA,SP,0.342,0.658,989,1903,2892
3534203,ORINDIÚVA,SP,0.398,0.602,1260,1902,3162
3553104,TAIAÇU,SP,0.394,0.606,1223,1884,3107
3500808,ALFREDO MARCONDES,SP,0.312,0.688,853,1880,2733
3507308,BORACÉIA,SP,0.279,0.721,721,1860,2581
3555356,UBARANA,SP,0.366,0.634,1072,1857,2929
3530409,MIRASSOLÂNDIA,SP,0.251,0.749,620,1847,2467
3505401,BARRA DO TURVO,SP,0.494,0.506,1802,1846,3648
3523701,ITIRAPUÃ,SP,0.437,0.563,1431,1845,3276
3517307,GUAIMBÊ,SP,0.38,0.62,1131,1843,2974
3555505,UBIRAJARA,SP,0.34,0.66,946,1837,2783
3503000,ARAMINA,SP,0.388,0.612,1164,1834,2998
3520806,INÚBIA PAULISTA,SP,0.176,0.824,390,1823,2213
3512704,CORUMBATAÍ,SP,0.186,0.814,414,1814,2228
3530904,MOMBUCA,SP,0.221,0.779,508,1788,2296
3545100,SALMOURÃO,SP,0.343,0.657,934,1786,2720
3527702,LUIZIÂNIA,SP,0.329,0.671,870,1772,2642
3533254,NOVAIS,SP,0.294,0.706,729,1749,2478
3543105,RIBEIRÃO CORRENTE,SP,0.354,0.646,960,1749,2709
3517109,GLICÉRIO,SP,0.353,0.647,956,1749,2705
3543501,RIVERSUL,SP,0.426,0.574,1291,1741,3032
3541109,PRESIDENTE ALVES,SP,0.272,0.728,649,1733,2382
3526506,LAVÍNIA,SP,0.365,0.635,993,1728,2721
3540101,PONGAÍ,SP,0.211,0.789,461,1723,2184
3534005,ONDA VERDE,SP,0.315,0.685,792,1721,2513
3509809,CAMPOS NOVOS PAULISTA,SP,0.315,0.685,789,1714,2503
3539608,PLANALTO,SP,0.4,0.6,1127,1693,2820
3502408,ANHUMAS,SP,0.3,0.7,724,1687,2411
3543600,RIFAINA,SP,0.339,0.661,857,1672,2529
3531704,MONTEIRO LOBATO,SP,0.337,0.663,844,1661,2505
3515350,EUCLIDES DA CUNHA PAULISTA,SP,0.633,0.367,2860,1660,4520
3532108,MURUTINGA DO SUL,SP,0.295,0.705,691,1652,2343
3548401,SANTÓPOLIS DO AGUAPEÍ,SP,0.291,0.709,662,1616,2278
3532207,NARANDIBA,SP,0.441,0.559,1264,1601,2865
3551306,SEBASTIANÓPOLIS DO SUL,SP,0.206,0.794,415,1600,2015
3514924,ELISIÁRIO,SP,0.218,0.782,444,1593,2037
3528858,MARAPOAMA,SP,0.147,0.853,274,1587,1861
3543204,RIBEIRÃO DO SUL,SP,0.418,0.582,1139,1583,2722
3529609,MERIDIANO,SP,0.318,0.682,734,1576,2310
3504305,AVAÍ,SP,0.416,0.584,1120,1571,2691
3516507,GABRIEL MONTEIRO,SP,0.168,0.832,314,1558,1872
3532702,NIPOÃ,SP,0.37,0.63,913,1557,2470
3502606,APARECIDA D'OESTE,SP,0.413,0.587,1090,1547,2637
3510153,CANITAR,SP,0.359,0.641,859,1536,2395
3541653,QUADRA,SP,0.25,0.75,503,1506,2009
3535903,PARANAPUÃ,SP,0.317,0.683,698,1506,2204
3522000,ITAJU,SP,0.258,0.742,523,1502,2025
3537156,PEDRINHAS PAULISTA,SP,0.258,0.742,512,1475,1987
3527801,LUPÉRCIO,SP,0.35,0.65,792,1470,2262
3534500,OSCAR BRESSANE,SP,0.211,0.789,386,1443,1829
3531605,MONTE CASTELO,SP,0.398,0.602,953,1439,2392
3528205,MACEDÔNIA,SP,0.297,0.703,606,1437,2043
3532058,MOTUCA,SP,0.408,0.592,981,1426,2407
3525607,JOÃO RAMALHO,SP,0.385,0.615,877,1403,2280
3505351,BARRA DO CHAPÉU,SP,0.526,0.474,1532,1383,2915
3516853,GAVIÃO PEIXOTO,SP,0.495,0.505,1353,1381,2734
3508306,CABRÁLIA PAULISTA,SP,0.404,0.596,932,1376,2308
3533700,OCAUÇU,SP,0.39,0.61,879,1374,2253
3525805,JÚLIO MESQUITA,SP,0.442,0.558,1087,1373,2460
3544509,RUBINÉIA,SP,0.293,0.707,569,1370,1939
3512605,CORONEL MACEDO,SP,0.497,0.503,1344,1362,2706
3515194,ESPÍRITO SANTO DO TURVO,SP,0.37,0.63,796,1354,2150
3533809,ÓLEO,SP,0.22,0.78,382,1351,1733
3554201,TEJUPÁ,SP,0.476,0.524,1204,1323,2527
3541802,QUEIROZ,SP,0.334,0.666,659,1314,1973
3508900,CAIABU,SP,0.459,0.541,1105,1305,2410
3540408,POPULINA,SP,0.466,0.534,1135,1301,2436
3539707,PLATINA,SP,0.303,0.697,564,1299,1863
3536257,PARISI,SP,0.241,0.759,411,1295,1706
3533205,NOVA INDEPENDÊNCIA,SP,0.38,0.62,786,1285,2071
3528304,MAGDA,SP,0.311,0.689,580,1282,1862
3518909,GUZOLÂNDIA,SP,0.456,0.544,1073,1280,2353
3528908,MARIÁPOLIS,SP,0.379,0.621,779,1275,2054
3549607,SÃO JOSÉ DO BARREIRO,SP,0.447,0.553,1027,1273,2300
3500907,ALTAIR,SP,0.389,0.611,808,1269,2077
3519253,IARAS,SP,0.523,0.477,1383,1263,2646
3525854,JUMIRIM,SP,0.217,0.783,345,1242,1587
3554656,TORRE DE PEDRA,SP,0.226,0.774,359,1230,1589
3515905,FLOREAL,SP,0.298,0.702,521,1230,1751
3510104,CÂNDIDO RODRIGUES,SP,0.26,0.74,430,1227,1657
3540259,PONTALINDA,SP,0.424,0.576,889,1210,2099
3501400,ÁLVARO DE CARVALHO,SP,0.368,0.632,703,1208,1911
3533304,NOVA LUZITÂNIA,SP,0.387,0.613,757,1200,1957
3509106,CAIUÁ,SP,0.524,0.476,1320,1197,2517
3514957,EMBAÚBA,SP,0.276,0.724,456,1195,1651
3520707,INDIAPORÃ,SP,0.422,0.578,870,1194,2064
3538303,PIQUEROBI,SP,0.424,0.576,851,1154,2005
3551207,SARUTAIÁ,SP,0.448,0.552,925,1140,2065
3540309,PONTES GESTAL,SP,0.337,0.663,577,1133,1710
3552551,SUZANÁPOLIS,SP,0.424,0.576,834,1133,1967
3557154,ZACARIAS,SP,0.288,0.712,457,1132,1589
3522653,ITAPIRAPUÃ PAULISTA,SP,0.47,0.53,999,1128,2127
3547403,SANTA RITA D'OESTE,SP,0.312,0.688,511,1127,1638
3548302,SANTO EXPEDITO,SP,0.383,0.617,698,1125,1823
3501509,ALVINLÂNDIA,SP,0.38,0.62,686,1118,1804
3525409,JERIQUARA,SP,0.436,0.564,862,1114,1976
3530003,MIRA ESTRELA,SP,0.339,0.661,569,1110,1679
3510906,CÁSSIA DOS COQUEIROS,SP,0.352,0.648,602,1106,1708
3507159,BOM SUCESSO DE ITARARÉ,SP,0.501,0.499,1095,1090,2185
3515129,EMILIANÓPOLIS,SP,0.413,0.587,766,1090,1856
3549003,SÃO FRANCISCO,SP,0.357,0.643,604,1087,1691
3513306,CRUZÁLIA,SP,0.311,0.689,488,1081,1569
3544400,RUBIÁCEA,SP,0.309,0.691,468,1048,1516
3516101,FLORÍNEA,SP,0.405,0.595,714,1048,1762
3507456,BOREBI,SP,0.321,0.679,495,1046,1541
3554607,TIMBURI,SP,0.325,0.675,500,1040,1540
3506201,BENTO DE ABREU,SP,0.292,0.708,426,1035,1461
3553658,TAQUARAL,SP,0.311,0.689,465,1032,1497
3547106,SANTA MERCEDES,SP,0.388,0.612,653,1029,1682
3505005,BARÃO DE ANTONINA,SP,0.42,0.58,736,1018,1754
3516804,GASTÃO VIDIGAL,SP,0.497,0.503,994,1005,1999
3527900,LUTÉCIA,SP,0.403,0.597,677,1001,1678
3542800,RIBEIRA,SP,0.498,0.502,981,988,1969
3546108,SANTA CLARA D'OESTE,SP,0.32,0.68,464,988,1452
3503356,ARCO-ÍRIS,SP,0.299,0.701,421,987,1408
3545506,SANDOVALINA,SP,0.574,0.426,1323,983,2306
3547650,SANTA SALETE,SP,0.239,0.761,307,980,1287
3528700,MARABÁ PAULISTA,SP,0.52,0.48,1057,974,2031
3503505,AREIAS,SP,0.539,0.461,1128,963,2091
3503158,ARAPEÍ,SP,0.396,0.604,624,950,1574
3546256,SANTA CRUZ DA ESPERANÇA,SP,0.285,0.715,375,941,1316
3532157,NANTES,SP,0.42,0.58,668,924,1592
3536570,PAULISTÂNIA,SP,0.235,0.765,281,917,1198
3527504,LUCIANÓPOLIS,SP,0.35,0.65,492,914,1406
3527256,LOURDES,SP,0.321,0.679,428,904,1332
3536901,PEDRANÓPOLIS,SP,0.369,0.631,527,900,1427
3531001,MONÇÕES,SP,0.328,0.672,439,900,1339
3507753,BREJO ALEGRE,SP,0.496,0.504,883,899,1782
3522158,ITAOCA,SP,0.506,0.494,910,888,1798
3515301,ESTRELA DO NORTE,SP,0.464,0.536,757,875,1632
3549201,SÃO JOÃO DAS DUAS PONTES,SP,0.438,0.562,680,873,1553
3544707,SAGRES,SP,0.385,0.615,542,865,1407
3549300,SÃO JOÃO DO PAU D'ALHO,SP,0.402,0.598,579,860,1439
3555208,TURIÚBA,SP,0.257,0.743,295,852,1147
3503950,ASPÁSIA,SP,0.357,0.643,455,818,1273
3521200,IPORANGA,SP,0.595,0.405,1195,813,2008
3523008,ITAPURA,SP,0.669,0.331,1578,782,2360
3515657,FERNÃO,SP,0.248,0.752,256,777,1033
3529104,MARINÓPOLIS,SP,0.391,0.609,496,772,1268
3555901,URU,SP,0.225,0.775,223,767,990
3556958,VITÓRIA BRASIL,SP,0.35,0.65,405,753,1158
3532843,NOVA CANAÃ PAULISTA,SP,0.412,0.588,526,750,1276
3533106,NOVA GUATAPORANGA,SP,0.445,0.555,597,744,1341
3547205,SANTANA DA PONTE PENSA,SP,0.314,0.686,336,733,1069
3555307,TURMALINA,SP,0.396,0.604,475,725,1200
3504701,BALBINOS,SP,0.24,0.76,227,719,946
3529658,MESÓPOLIS,SP,0.385,0.615,447,713,1160
3555703,UNIÃO PAULISTA,SP,0.343,0.657,368,705,1073
3554755,TRABIJU,SP,0.39,0.61,436,681,1117
3514205,DOLCINÓPOLIS,SP,0.551,0.449,831,677,1508
3543238,RIBEIRÃO DOS ÍNDIOS,SP,0.466,0.534,590,676,1266
3532868,NOVA CASTILHO,SP,0.243,0.757,206,641,847
3513850,DIRCE REIS,SP,0.429,0.571,465,618,1083
3515806,FLORA RICA,SP,0.445,0.555,483,603,1086
3518008,GUARANI D'OESTE,SP,0.441,0.559,459,582,1041
3540853,PRACINHA,SP,0.36,0.64,325,578,903
3549250,SÃO JOÃO DE IRACEMA,SP,0.483,0.517,534,572,1106
3507209,BORÁ,SP,0.308,0.692,234,525,759
2800308,ARACAJU,SE,0.528,0.472,155892,139603,295495
2804805,NOSSA SENHORA DO SOCORRO,SE,0.569,0.431,42414,32091,74505
2802908,ITABAIANA,SE,0.657,0.343,31846,16608,48454
2806701,SÃO CRISTÓVÃO,SE,0.64,0.36,25032,14108,39140
2803500,LAGARTO,SE,0.735,0.265,38486,13887,52373
2802106,ESTÂNCIA,SE,0.741,0.259,24515,8590,33105
2807402,TOBIAS BARRETO,SE,0.756,0.244,21192,6832,28024
2803005,ITABAIANINHA,SE,0.702,0.298,14754,6270,21024
2800605,BARRA DOS COQUEIROS,SE,0.579,0.421,8149,5914,14063
2807105,SIMÃO DIAS,SE,0.793,0.207,19094,4971,24065
2803203,ITAPORANGA D'AJUDA,SE,0.73,0.27,13186,4872,18058
2805703,PROPRIÁ,SE,0.665,0.335,9340,4715,14055
2803609,LARANJEIRAS,SE,0.691,0.309,10434,4663,15097
2801306,CAPELA,SE,0.717,0.283,11271,4454,15725
2804607,NOSSA SENHORA DAS DORES,SE,0.69,0.31,9763,4384,14147
2800670,BOQUIM,SE,0.732,0.268,10488,3847,14335
2804508,NOSSA SENHORA DA GLÓRIA,SE,0.818,0.182,16250,3622,19872
2802304,FREI PAULO,SE,0.613,0.387,5505,3475,8980
2807600,UMBAÚBA,SE,0.742,0.258,9162,3193,12355
2806008,RIBEIRÓPOLIS,SE,0.673,0.327,6578,3192,9770
2801504,CARMÓPOLIS,SE,0.649,0.351,5601,3028,8629
2805604,PORTO DA FOLHA,SE,0.811,0.189,12453,2902,15355
2805406,POÇO REDONDO,SE,0.796,0.204,11124,2853,13977
2801207,CANINDÉ DE SÃO FRANCISCO,SE,0.82,0.18,12679,2788,15467
2800506,AREIA BRANCA,SE,0.713,0.287,6638,2678,9316
2803302,JAPARATUBA,SE,0.742,0.258,7201,2508,9709
2805505,POÇO VERDE,SE,0.824,0.176,10479,2233,12712
2801405,CARIRA,SE,0.808,0.192,9381,2225,11606
2806206,SALGADO,SE,0.804,0.196,9100,2222,11322
2801009,CAMPO DO BRITO,SE,0.773,0.227,7539,2211,9750
2800209,AQUIDABÃ,SE,0.797,0.203,8619,2193,10812
2804409,NEÓPOLIS,SE,0.766,0.234,7060,2159,9219
2805802,RIACHÃO DO DANTAS,SE,0.834,0.166,9942,1984,11926
2804102,MOITA BONITA,SE,0.682,0.318,4091,1906,5997
2806800,SÃO DOMINGOS,SE,0.644,0.356,3451,1905,5356
2804003,MARUIM,SE,0.79,0.21,6999,1860,8859
2804201,MONTE ALEGRE DE SERGIPE,SE,0.791,0.209,6231,1643,7874
2807501,TOMAR DO GERU,SE,0.759,0.241,4859,1540,6399
2803906,MALHADOR,SE,0.78,0.22,5417,1530,6947
2804458,NOSSA SENHORA APARECIDA,SE,0.711,0.289,3689,1502,5191
2801702,CRISTINÁPOLIS,SE,0.832,0.168,7394,1488,8882
2805307,PIRAMBU,SE,0.723,0.277,3827,1466,5293
2803401,JAPOATÃ,SE,0.821,0.179,6036,1315,7351
2806107,ROSÁRIO DO CATETE,SE,0.779,0.221,4512,1283,5795
2800407,ARAUÁ,SE,0.803,0.197,5115,1256,6371
2804904,PACATUBA,SE,0.827,0.173,5945,1247,7192
2802809,INDIAROBA,SE,0.846,0.154,6795,1240,8035
2803708,MACAMBIRA,SE,0.716,0.284,3124,1239,4363
2805901,RIACHUELO,SE,0.783,0.217,4394,1219,5613
2806305,SANTA LUZIA DO ITANHY,SE,0.837,0.163,5859,1143,7002
2805109,PEDRINHAS,SE,0.774,0.226,3733,1089,4822
2804300,MURIBECA,SE,0.763,0.237,3511,1088,4599
2807204,SIRIRI,SE,0.765,0.235,3508,1079,4587
2802700,ILHA DAS FLORES,SE,0.781,0.219,3539,990,4529
2801603,CEDRO DE SÃO JOÃO,SE,0.72,0.28,2530,985,3515
2806404,SANTANA DO SÃO FRANCISCO,SE,0.768,0.232,3026,912,3938
2801900,CUMBE,SE,0.694,0.306,1908,840,2748
2802403,GARARU,SE,0.87,0.13,5632,839,6471
2806602,SANTO AMARO DAS BROTAS,SE,0.866,0.134,5254,814,6068
2803104,ITABI,SE,0.745,0.255,2332,800,3132
2800704,BREJO GRANDE,SE,0.816,0.184,3536,797,4333
2805208,PINHÃO,SE,0.773,0.227,2691,792,3483
2802205,FEIRA NOVA,SE,0.803,0.197,3222,792,4014
2805000,PEDRA MOLE,SE,0.645,0.355,1442,792,2234
2807303,TELHA,SE,0.703,0.297,1720,726,2446
2804706,NOSSA SENHORA DE LOURDES,SE,0.832,0.168,3478,704,4182
2802601,GRACHO CARDOSO,SE,0.835,0.165,3465,683,4148
2806503,SANTA ROSA DE LIMA,SE,0.761,0.239,2001,628,2629
2807006,SÃO MIGUEL DO ALEIXO,SE,0.802,0.198,2101,520,2621
2802007,DIVINA PASTORA,SE,0.806,0.194,2125,510,2635
2803807,MALHADA DOS BOIS,SE,0.81,0.19,2165,509,2674
2801108,CANHOBA,SE,0.837,0.163,2565,500,3065
2802502,GENERAL MAYNARD,SE,0.741,0.259,1402,490,1892
2806909,SÃO FRANCISCO,SE,0.806,0.194,1988,477,2465
2800100,AMPARO DE SÃO FRANCISCO,SE,0.741,0.259,1282,447,1729
1721000,PALMAS,TO,0.351,0.649,45892,84782,130674
1702109,ARAGUAÍNA,TO,0.403,0.597,31320,46436,77756
1709500,GURUPI,TO,0.373,0.627,14655,24613,39268
1716109,PARAÍSO DO TOCANTINS,TO,0.29,0.71,6609,16149,22758
1718204,PORTO NACIONAL,TO,0.523,0.477,15105,13764,28869
1705508,COLINAS DO TOCANTINS,TO,0.424,0.576,6805,9249,16054
1709302,GUARAÍ,TO,0.431,0.569,4965,6544,11509
1702208,ARAGUATINS,TO,0.6,0.4,8819,5882,14701
1708205,FORMOSO DO ARAGUAIA,TO,0.457,0.543,4217,5013,9230
1713205,MIRACEMA DO TOCANTINS,TO,0.611,0.389,5913,3769,9682
1721208,TOCANTINÓPOLIS,TO,0.677,0.323,7512,3592,11104
1713304,MIRANORTE,TO,0.499,0.501,3333,3352,6685
1716505,PEDRO AFONSO,TO,0.503,0.497,3270,3226,6496
1702554,AUGUSTINÓPOLIS,TO,0.638,0.362,5598,3171,8769
1707009,DIANÓPOLIS,TO,0.633,0.367,5206,3012,8218
1702000,ARAGUAÇU,TO,0.324,0.676,1436,3001,4437
1722107,XAMBIOÁ,TO,0.496,0.504,2888,2939,5827
1716703,COLMÉIA,TO,0.406,0.594,1780,2607,4387
1700707,ALVORADA,TO,0.442,0.558,1989,2516,4505
1711902,LAGOA DA CONFUSÃO,TO,0.559,0.441,3140,2479,5619
1720903,TAGUATINGA,TO,0.646,0.354,4471,2451,6922
1714880,NOVA OLINDA,TO,0.573,0.427,3277,2443,5720
1702901,AXIXÁ DO TOCANTINS,TO,0.653,0.347,4033,2147,6180
1715754,PALMEIRÓPOLIS,TO,0.442,0.558,1658,2089,3747
1722081,WANDERLÂNDIA,TO,0.585,0.415,2735,1944,4679
1701002,ANANÁS,TO,0.637,0.363,3195,1823,5018
1714203,NATIVIDADE,TO,0.569,0.431,2346,1780,4126
1717503,PIUM,TO,0.471,0.529,1585,1779,3364
1720200,SÃO MIGUEL DO TOCANTINS,TO,0.691,0.309,3786,1690,5476
1706100,CRISTALÂNDIA,TO,0.531,0.469,1903,1681,3584
1716604,PEIXE,TO,0.659,0.341,3158,1633,4791
1720804,SÍTIO NOVO DO TOCANTINS,TO,0.722,0.278,4045,1556,5601
1703800,BURITI DO TOCANTINS,TO,0.662,0.338,3017,1539,4556
1717909,PONTE ALTA DO TOCANTINS,TO,0.552,0.448,1852,1502,3354
1703107,BARROLÂNDIA,TO,0.507,0.493,1545,1501,3046
1707702,FILADÉLFIA,TO,0.643,0.357,2646,1470,4116
1709005,GOIATINS,TO,0.731,0.269,3960,1459,5419
1710508,ITACAJÁ,TO,0.626,0.374,2422,1447,3869
1707652,FIGUEIRÓPOLIS,TO,0.497,0.503,1418,1433,2851
1702307,ARAPOEMA,TO,0.567,0.433,1811,1385,3196
1718865,SANTA FÉ DO ARAGUAIA,TO,0.575,0.425,1866,1380,3246
1707108,DIVINÓPOLIS DO TOCANTINS,TO,0.623,0.377,2283,1380,3663
1702406,ARRAIAS,TO,0.734,0.266,3642,1323,4965
1705557,COMBINADO,TO,0.479,0.521,1182,1285,2467
1703008,BABAÇULÂNDIA,TO,0.722,0.278,3312,1276,4588
1700350,ALIANÇA DO TOCANTINS,TO,0.544,0.456,1449,1215,2664
1720655,SILVANÓPOLIS,TO,0.601,0.399,1793,1192,2985
1701101,APARECIDA DO RIO NEGRO,TO,0.524,0.476,1291,1171,2462
1703842,CAMPOS LINDOS,TO,0.705,0.295,2797,1168,3965
1708304,GOIANORTE,TO,0.594,0.406,1680,1146,2826
1703701,BREJINHO DE NAZARÉ,TO,0.576,0.424,1542,1135,2677
1713601,MONTE DO CARMO,TO,0.633,0.367,1959,1134,3093
1703867,CARIRI DO TOCANTINS,TO,0.473,0.527,1011,1127,2138
1702158,ARAGUANÃ,TO,0.553,0.447,1367,1107,2474
1703206,BERNARDO SAYÃO,TO,0.493,0.507,1068,1100,2168
1707553,FÁTIMA,TO,0.464,0.536,946,1092,2038
1716653,PEQUIZEIRO,TO,0.603,0.397,1631,1073,2704
1707405,ESPERANTINA,TO,0.745,0.255,3125,1070,4195
1718840,SANDOLÂNDIA,TO,0.494,0.506,1045,1069,2114
1707207,DOIS IRMÃOS DO TOCANTINS,TO,0.67,0.33,2168,1066,3234
1712009,LAJEADO,TO,0.499,0.501,1047,1053,2100
1701903,ARAGUACEMA,TO,0.668,0.332,2120,1053,3173
1716307,PAU D'ARCO,TO,0.56,0.44,1320,1037,2357
1706001,COUTO MAGALHÃES,TO,0.647,0.353,1886,1027,2913
1700400,ALMAS,TO,0.684,0.316,2214,1022,3236
1715002,NOVA ROSALÂNDIA,TO,0.454,0.546,849,1022,1871
1717008,PINDORAMA DO TOCANTINS,TO,0.559,0.441,1290,1016,2306
1718303,PRAIA NORTE,TO,0.733,0.267,2738,996,3734
1715101,NOVO ACORDO,TO,0.581,0.419,1373,992,2365
1706506,DARCINÓPOLIS,TO,0.647,0.353,1814,991,2805
1701309,ARAGOMINAS,TO,0.656,0.344,1875,984,2859
1713809,PALMEIRAS DO TOCANTINS,TO,0.64,0.36,1744,981,2725
1718758,RIO SONO,TO,0.628,0.372,1616,959,2575
1716208,PARANÃ,TO,0.809,0.191,4008,949,4957
1707306,DUERÉ,TO,0.561,0.439,1206,945,2151
1703909,CASEARA,TO,0.651,0.349,1706,915,2621
1710706,ITAGUATINS,TO,0.714,0.286,2276,912,3188
1700301,AGUIARNÓPOLIS,TO,0.66,0.34,1723,887,2610
1703305,BOM JESUS DO TOCANTINS,TO,0.589,0.411,1258,877,2135
1719004,SANTA TEREZA DO TOCANTINS,TO,0.492,0.508,843,869,1712
1721109,TOCANTÍNIA,TO,0.756,0.244,2683,867,3550
1703057,BANDEIRANTES DO TOCANTINS,TO,0.496,0.504,846,860,1706
1718402,PRESIDENTE KENNEDY,TO,0.52,0.48,919,849,1768
1708254,FORTALEZA DO TABOCÃO,TO,0.529,0.471,952,846,1798
1713700,MONTE SANTO DO TOCANTINS,TO,0.473,0.527,750,835,1585
1720101,SÃO BENTO DO TOCANTINS,TO,0.718,0.282,2020,792,2812
1711506,JAÚ DO TOCANTINS,TO,0.573,0.427,1056,788,1844
1712504,MARIANÓPOLIS DO TOCANTINS,TO,0.633,0.367,1340,776,2116
1701051,ANGICO,TO,0.553,0.447,920,744,1664
1702703,AURORA DO TOCANTINS,TO,0.613,0.387,1173,740,1913
1714302,NAZARÉ,TO,0.726,0.274,1934,730,2664
1718550,RIACHINHO,TO,0.694,0.306,1650,726,2376
1718907,SANTA ROSA DO TOCANTINS,TO,0.718,0.282,1850,725,2575
1720978,TALISMÃ,TO,0.551,0.449,872,710,1582
1710904,ITAPIRATINS,TO,0.661,0.339,1312,673,1985
1715705,PALMEIRANTE,TO,0.725,0.275,1763,669,2432
1711100,ITAPORÃ DO TOCANTINS,TO,0.546,0.454,797,663,1460
1703073,BARRA DO OURO,TO,0.73,0.27,1755,648,2403
1720499,SÃO VALÉRIO,TO,0.721,0.279,1660,642,2302
1718451,PUGMIL,TO,0.472,0.528,572,641,1213
1717800,PONTE ALTA DO BOM JESUS,TO,0.714,0.286,1582,635,2217
1704600,CHAPADA DE AREIA,TO,0.494,0.506,619,634,1253
1718881,SANTA MARIA DO TOCANTINS,TO,0.596,0.404,903,613,1516
1718808,SAMPAIO,TO,0.72,0.28,1525,593,2118
1720309,SÃO SEBASTIÃO DO TOCANTINS,TO,0.744,0.256,1662,571,2233
1718899,SANTA RITA DO TOCANTINS,TO,0.516,0.484,598,561,1159
1720853,SUCUPIRA,TO,0.497,0.503,544,550,1094
1711951,LAGOA DO TOCANTINS,TO,0.696,0.304,1250,547,1797
1718709,RIO DOS BOIS,TO,0.635,0.365,945,544,1489
1717206,PIRAQUÊ,TO,0.631,0.369,930,543,1473
1700251,ABREULÂNDIA,TO,0.612,0.388,856,542,1398
1713957,MURICILÂNDIA,TO,0.67,0.33,1077,530,1607
1703602,BRASILÂNDIA DO TOCANTINS,TO,0.544,0.456,631,529,1160
1703883,CARMOLÂNDIA,TO,0.631,0.369,901,527,1428
1703891,CARRASCO BONITO,TO,0.73,0.27,1407,520,1927
1712454,LUZINÓPOLIS,TO,0.649,0.351,958,517,1475
1721257,TUPIRAMA,TO,0.568,0.432,665,505,1170
1711803,JUARINA,TO,0.618,0.382,815,504,1319
1718501,RECURSOLÂNDIA,TO,0.733,0.267,1331,485,1816
1720002,SANTA TEREZINHA DO TOCANTINS,TO,0.651,0.349,893,478,1371
1705607,CONCEIÇÃO DO TOCANTINS,TO,0.751,0.249,1372,455,1827
1712801,MAURILÂNDIA DO TOCANTINS,TO,0.771,0.229,1523,453,1976
1715150,NOVO ALEGRE,TO,0.622,0.378,740,449,1189
1705102,CHAPADA DA NATIVIDADE,TO,0.756,0.244,1331,430,1761
1715259,NOVO JARDIM,TO,0.679,0.321,860,407,1267
1715507,OLIVEIRA DE FÁTIMA,TO,0.6,0.4,606,404,1010
1718006,PORTO ALEGRE DO TOCANTINS,TO,0.713,0.287,995,401,1396
1712702,MATEIROS,TO,0.684,0.316,851,394,1245
1712157,LAVANDEIRA,TO,0.622,0.378,646,393,1039
1706258,CRIXÁS DO TOCANTINS,TO,0.588,0.412,542,380,922
1703826,CACHOEIRINHA,TO,0.694,0.306,827,365,1192
1704105,CENTENÁRIO,TO,0.704,0.296,841,354,1195
1720259,SÃO SALVADOR DO TOCANTINS,TO,0.749,0.251,1052,353,1405
1721307,TUPIRATINS,TO,0.71,0.29,825,337,1162
1718659,RIO DA CONCEIÇÃO,TO,0.697,0.303,760,331,1091
1712405,LIZARDA,TO,0.801,0.199,1324,329,1653
1709807,IPUEIRAS,TO,0.729,0.271,751,279,1030
1720937,TAIPAS DO TOCANTINS,TO,0.747,0.253,812,275,1087
1720150,SÃO FÉLIX DO TOCANTINS,TO,0.763,0.237,641,199,840
